    - 北京:
      - 中华女子学院: universities/zhong-hua-nu-zi-xue-yuan.md
      - 中国人民公安大学: universities/zhong-guo-ren-min-gong-an-da-xue.md
      - 中国人民大学: universities/zhong-guo-ren-min-da-xue.md
      - 中国传媒大学: universities/zhong-guo-chuan-mei-da-xue.md
      - 中国农业大学: universities/zhong-guo-nong-ye-da-xue.md
      - 中国农业大学烟台研究院: universities/zhong-guo-nong-ye-da-xue-yan-tai-yan-jiu-yuan.md
      - 中国劳动关系学院: universities/zhong-guo-lao-dong-guan-xi-xue-yuan.md
      - 中国地质大学北京: universities/zhong-guo-di-zhi-da-xue-bei-jing.md
      - 中国政法大学: universities/zhong-guo-zheng-fa-da-xue.md
      - 中国石油大学北京: universities/zhong-guo-shi-you-da-xue-bei-jing.md
      - 中国矿业大学北京: universities/zhong-guo-kuang-ye-da-xue-bei-jing.md
      - 中国社会科学院大学: universities/zhong-guo-she-hui-ke-xue-yuan-da-xue.md
      - 中国科学院大学: universities/zhong-guo-ke-xue-yuan-da-xue.md
      - 中央戏剧学院: universities/zhong-yang-xi-ju-xue-yuan.md
      - 中央民族大学: universities/zhong-yang-min-zu-da-xue.md
      - 中央财经大学: universities/zhong-yang-cai-jing-da-xue.md
      - 北京中医药大学: universities/bei-jing-zhong-yi-yao-da-xue.md
      - 北京中医药大学良乡校区: universities/bei-jing-zhong-yi-yao-da-xue-liang-xiang-xiao-qu.md
      - 北京交通大学: universities/bei-jing-jiao-tong-da-xue.md
      - 北京交通大学中外合作威海校区: universities/bei-jing-jiao-tong-da-xue-zhong-wai-he-zuo-wei-hai-xiao-qu.md
      - 北京交通大学主校区: universities/bei-jing-jiao-tong-da-xue-zhu-xiao-qu.md
      - 北京交通运输职业学院: universities/bei-jing-jiao-tong-yun-shu-zhi-ye-xue-yuan.md
      - 北京体育大学: universities/bei-jing-ti-yu-da-xue.md
      - 北京信息科技大学: universities/bei-jing-xin-xi-ke-ji-da-xue.md
      - 北京信息职业技术学院: universities/bei-jing-xin-xi-zhi-ye-ji-zhu-xue-yuan.md
      - 北京信息职业技术学院校本部: universities/bei-jing-xin-xi-zhi-ye-ji-zhu-xue-yuan-xiao-ben-bu.md
      - 北京农学院: universities/bei-jing-nong-xue-yuan.md
      - 北京化工大学: universities/bei-jing-hua-gong-da-xue.md
      - 北京卫生职业学院一院区: universities/bei-jing-wei-sheng-zhi-ye-xue-yuan-yi-yuan-qu.md
      - 北京印刷学院: universities/bei-jing-yin-shua-xue-yuan.md
      - 北京城市学院: universities/bei-jing-cheng-shi-xue-yuan.md
      - 北京外国语大学: universities/bei-jing-wai-guo-yu-da-xue.md
      - 北京大学: universities/bei-jing-da-xue.md
      - 北京大学医学部: universities/bei-jing-da-xue-yi-xue-bu.md
      - 北京工业大学: universities/bei-jing-gong-ye-da-xue.md
      - 北京工业大学耿丹学院: universities/bei-jing-gong-ye-da-xue-geng-dan-xue-yuan.md
      - 北京工业职业技术学院: universities/bei-jing-gong-ye-zhi-ye-ji-zhu-xue-yuan.md
      - 北京工商大学: universities/bei-jing-gong-shang-da-xue.md
      - 北京工商大学嘉华学院: universities/bei-jing-gong-shang-da-xue-jia-hua-xue-yuan.md
      - 北京工商大学良乡校区: universities/bei-jing-gong-shang-da-xue-liang-xiang-xiao-qu.md
      - 北京工商大学阜成路校区本科: universities/bei-jing-gong-shang-da-xue-fu-cheng-lu-xiao-qu-ben-ke.md
      - 北京师范大学: universities/bei-jing-shi-fan-da-xue.md
      - 北京建筑大学: universities/bei-jing-jian-zhu-da-xue.md
      - 北京服装学院: universities/bei-jing-fu-zhuang-xue-yuan.md
      - 北京林业大学: universities/bei-jing-lin-ye-da-xue.md
      - 北京物资学院: universities/bei-jing-wu-zi-xue-yuan.md
      - 北京理工大学: universities/bei-jing-li-gong-da-xue.md
      - 北京理工大学良乡校区: universities/bei-jing-li-gong-da-xue-liang-xiang-xiao-qu.md
      - 北京电子科技学院: universities/bei-jing-dian-zi-ke-ji-xue-yuan.md
      - 北京电子科技职业学院: universities/bei-jing-dian-zi-ke-ji-zhi-ye-xue-yuan.md
      - 北京电影学院: universities/bei-jing-dian-ying-xue-yuan.md
      - 北京电影学院怀柔校区: universities/bei-jing-dian-ying-xue-yuan-huai-rou-xiao-qu.md
      - 北京石油化工学院: universities/bei-jing-shi-you-hua-gong-xue-yuan.md
      - 北京科技大学: universities/bei-jing-ke-ji-da-xue.md
      - 北京第二外国语学院: universities/bei-jing-di-er-wai-guo-yu-xue-yuan.md
      - 北京第二外国语学院中瑞酒店管理学院: universities/bei-jing-di-er-wai-guo-yu-xue-yuan-zhong-rui-jiu-dian-guan-li-xue-yuan.md
      - 北京经济管理职业学院: universities/bei-jing-jing-ji-guan-li-zhi-ye-xue-yuan.md
      - 北京经贸职业学院: universities/bei-jing-jing-mao-zhi-ye-xue-yuan.md
      - 北京联合大学: universities/bei-jing-lian-he-da-xue.md
      - 北京联合大学北四环校区: universities/bei-jing-lian-he-da-xue-bei-si-huan-xiao-qu.md
      - 北京联合大学师范学院: universities/bei-jing-lian-he-da-xue-shi-fan-xue-yuan.md
      - 北京联合大学应用文理学院: universities/bei-jing-lian-he-da-xue-ying-yong-wen-li-xue-yuan.md
      - 北京航空航天大学: universities/bei-jing-hang-kong-hang-tian-da-xue.md
      - 北京航空航天大学中法航空学院: universities/bei-jing-hang-kong-hang-tian-da-xue-zhong-fa-hang-kong-xue-yuan.md
      - 北京艺术传媒职业学院: universities/bei-jing-yi-zhu-chuan-mei-zhi-ye-xue-yuan.md
      - 北京警察学院: universities/bei-jing-jing-cha-xue-yuan.md
      - 北京语言大学: universities/bei-jing-yu-yan-da-xue.md
      - 北京邮电大学: universities/bei-jing-you-dian-da-xue.md
      - 北京邮电大学世纪学院: universities/bei-jing-you-dian-da-xue-shi-ji-xue-yuan.md
      - 北京邮电大学沙河校区: universities/bei-jing-you-dian-da-xue-sha-he-xiao-qu.md
      - 北方工业大学: universities/bei-fang-gong-ye-da-xue.md
      - 华北电力大学: universities/hua-bei-dian-li-da-xue.md
      - 华北电力大学北京: universities/hua-bei-dian-li-da-xue-bei-jing.md
      - 华北电力大学北京校区: universities/hua-bei-dian-li-da-xue-bei-jing-xiao-qu.md
      - 外交学院: universities/wai-jiao-xue-yuan.md
      - 对外经济贸易大学: universities/dui-wai-jing-ji-mao-yi-da-xue.md
      - 清华大学: universities/qing-hua-da-xue.md
      - 首都医科大学: universities/shou-du-yi-ke-da-xue.md
      - 首都师范大学: universities/shou-du-shi-fan-da-xue.md
      - 首都经济贸易大学: universities/shou-du-jing-ji-mao-yi-da-xue.md
    - 天津:
      - 中国民航大学: universities/zhong-guo-min-hang-da-xue.md
      - 北京科技大学天津学院: universities/bei-jing-ke-ji-da-xue-tian-jin-xue-yuan.md
      - 南开大学: universities/nan-kai-da-xue.md
      - 天津中医药大学: universities/tian-jin-zhong-yi-yao-da-xue.md
      - 天津中医药大学新校区: universities/tian-jin-zhong-yi-yao-da-xue-xin-xiao-qu.md
      - 天津中德应用技术大学: universities/tian-jin-zhong-de-ying-yong-ji-zhu-da-xue.md
      - 天津仁爱学院: universities/tian-jin-ren-ai-xue-yuan.md
      - 天津传媒学院: universities/tian-jin-chuan-mei-xue-yuan.md
      - 天津体育学院: universities/tian-jin-ti-yu-xue-yuan.md
      - 天津体育职业学院: universities/tian-jin-ti-yu-zhi-ye-xue-yuan.md
      - 天津农学院: universities/tian-jin-nong-xue-yuan.md
      - 天津医科大学: universities/tian-jin-yi-ke-da-xue.md
      - 天津医科大学临床医学院: universities/tian-jin-yi-ke-da-xue-lin-chuang-yi-xue-yuan.md
      - 天津医科大学气象台路校区: universities/tian-jin-yi-ke-da-xue-qi-xiang-tai-lu-xiao-qu.md
      - 天津商业大学: universities/tian-jin-shang-ye-da-xue.md
      - 天津商业大学宝德学院: universities/tian-jin-shang-ye-da-xue-bao-de-xue-yuan.md
      - 天津商务职业学院: universities/tian-jin-shang-wu-zhi-ye-xue-yuan.md
      - 天津城市建设管理职业技术学院: universities/tian-jin-cheng-shi-jian-she-guan-li-zhi-ye-ji-zhu-xue-yuan.md
      - 天津城市职业学院: universities/tian-jin-cheng-shi-zhi-ye-xue-yuan.md
      - 天津城建大学: universities/tian-jin-cheng-jian-da-xue.md
      - 天津外国语大学: universities/tian-jin-wai-guo-yu-da-xue.md
      - 天津外国语大学滨海校区: universities/tian-jin-wai-guo-yu-da-xue-bin-hai-xiao-qu.md
      - 天津大学: universities/tian-jin-da-xue.md
      - 天津工业大学: universities/tian-jin-gong-ye-da-xue.md
      - 天津市职业大学: universities/tian-jin-shi-zhi-ye-da-xue.md
      - 天津师范大学: universities/tian-jin-shi-fan-da-xue.md
      - 天津机电职业技术学院: universities/tian-jin-ji-dian-zhi-ye-ji-zhu-xue-yuan.md
      - 天津渤海职业技术学院: universities/tian-jin-bo-hai-zhi-ye-ji-zhu-xue-yuan.md
      - 天津滨海职业学院: universities/tian-jin-bin-hai-zhi-ye-xue-yuan.md
      - 天津现代职业技术学院: universities/tian-jin-xian-dai-zhi-ye-ji-zhu-xue-yuan.md
      - 天津理工大学: universities/tian-jin-li-gong-da-xue.md
      - 天津理工大学中环信息学院: universities/tian-jin-li-gong-da-xue-zhong-huan-xin-xi-xue-yuan.md
      - 天津生物工程职业技术学院: universities/tian-jin-sheng-wu-gong-cheng-zhi-ye-ji-zhu-xue-yuan.md
      - 天津电子信息职业技术学院: universities/tian-jin-dian-zi-xin-xi-zhi-ye-ji-zhu-xue-yuan.md
      - 天津石油职业技术学院: universities/tian-jin-shi-you-zhi-ye-ji-zhu-xue-yuan.md
      - 天津科技大学: universities/tian-jin-ke-ji-da-xue.md
      - 天津科技大学泰达校区：就是滨海校区: universities/tian-jin-ke-ji-da-xue-tai-da-xiao-qu-jiu-shi-bin-hai-xiao-qu.md
      - 天津美术学院北院: universities/tian-jin-mei-shu-xue-yuan-bei-yuan.md
      - 天津职业技术师范大学: universities/tian-jin-zhi-ye-ji-zhu-shi-fan-da-xue.md
      - 天津财经大学: universities/tian-jin-cai-jing-da-xue.md
      - 天津财经大学珠江学院: universities/tian-jin-cai-jing-da-xue-zhu-jiang-xue-yuan.md
      - 天津音乐学院: universities/tian-jin-yin-le-xue-yuan.md
      - 河北工业大学: universities/he-bei-gong-ye-da-xue.md
      - 河北工业大学北辰校区: universities/he-bei-gong-ye-da-xue-bei-chen-xiao-qu.md
    - 河北:
      - 东北大学秦皇岛分校: universities/dong-bei-da-xue-qin-huang-dao-fen-xiao.md
      - 中央司法警官学院: universities/zhong-yang-si-fa-jing-guan-xue-yuan.md
      - 保定学院: universities/bao-ding-xue-yuan.md
      - 保定幼儿师范高等专科学校: universities/bao-ding-you-er-shi-fan-gao-deng-zhuan-ke-xue-xiao.md
      - 保定职业技术学院: universities/bao-ding-zhi-ye-ji-zhu-xue-yuan.md
      - 北京中医药大学东方学院: universities/bei-jing-zhong-yi-yao-da-xue-dong-fang-xue-yuan.md
      - 北华航天工业学院: universities/bei-hua-hang-tian-gong-ye-xue-yuan.md
      - 华北理工大学: universities/hua-bei-li-gong-da-xue.md
      - 华北理工大学曹妃甸校区: universities/hua-bei-li-gong-da-xue-cao-fei-dian-xiao-qu.md
      - 华北理工大学轻工学院: universities/hua-bei-li-gong-da-xue-qing-gong-xue-yuan.md
      - 华北电力大学保定: universities/hua-bei-dian-li-da-xue-bao-ding.md
      - 华北电力大学保定二校区: universities/hua-bei-dian-li-da-xue-bao-ding-er-xiao-qu.md
      - 华北电力大学保定校区: universities/hua-bei-dian-li-da-xue-bao-ding-xiao-qu.md
      - 华北科技学院: universities/hua-bei-ke-ji-xue-yuan.md
      - 唐山学院: universities/tang-shan-xue-yuan.md
      - 唐山工业职业技术学院: universities/tang-shan-gong-ye-zhi-ye-ji-zhu-xue-yuan.md
      - 唐山师范学院: universities/tang-shan-shi-fan-xue-yuan.md
      - 唐山海运职业学院: universities/tang-shan-hai-yun-zhi-ye-xue-yuan.md
      - 唐山科技职业技术学院: universities/tang-shan-ke-ji-zhi-ye-ji-zhu-xue-yuan.md
      - 唐山职业技术学院: universities/tang-shan-zhi-ye-ji-zhu-xue-yuan.md
      - 廊坊师范学院: universities/lang-fang-shi-fan-xue-yuan.md
      - 廊坊燕京职业技术学院: universities/lang-fang-yan-jing-zhi-ye-ji-zhu-xue-yuan.md
      - 承德医学院: universities/cheng-de-yi-xue-yuan.md
      - 承德应用技术职业学院: universities/cheng-de-ying-yong-ji-zhu-zhi-ye-xue-yuan.md
      - 沧州交通学院: universities/cang-zhou-jiao-tong-xue-yuan.md
      - 沧州医学高等专科学校: universities/cang-zhou-yi-xue-gao-deng-zhuan-ke-xue-xiao.md
      - 沧州师范学院: universities/cang-zhou-shi-fan-xue-yuan.md
      - 沧州职业技术学院沧东分院: universities/cang-zhou-zhi-ye-ji-zhu-xue-yuan-cang-dong-fen-yuan.md
      - 河北东方学院: universities/he-bei-dong-fang-xue-yuan.md
      - 河北交通职业技术学院: universities/he-bei-jiao-tong-zhi-ye-ji-zhu-xue-yuan.md
      - 河北传媒学院: universities/he-bei-chuan-mei-xue-yuan.md
      - 河北公安警察职业学院: universities/he-bei-gong-an-jing-cha-zhi-ye-xue-yuan.md
      - 河北农业大学: universities/he-bei-nong-ye-da-xue.md
      - 河北农业大学渤海校区: universities/he-bei-nong-ye-da-xue-bo-hai-xiao-qu.md
      - 河北农业大学现代科技学院: universities/he-bei-nong-ye-da-xue-xian-dai-ke-ji-xue-yuan.md
      - 河北北方学院: universities/he-bei-bei-fang-xue-yuan.md
      - 河北医科大学: universities/he-bei-yi-ke-da-xue.md
      - 河北医科大学中山校区: universities/he-bei-yi-ke-da-xue-zhong-shan-xiao-qu.md
      - 河北医科大学临床学院: universities/he-bei-yi-ke-da-xue-lin-chuang-xue-yuan.md
      - 河北司法警官职业学院: universities/he-bei-si-fa-jing-guan-zhi-ye-xue-yuan.md
      - 河北地质大学: universities/he-bei-di-zhi-da-xue.md
      - 河北外国语学院: universities/he-bei-wai-guo-yu-xue-yuan.md
      - 河北大学: universities/he-bei-da-xue.md
      - 河北大学七一路校区: universities/he-bei-da-xue-qi-yi-lu-xiao-qu.md
      - 河北对外经贸职业学院: universities/he-bei-dui-wai-jing-mao-zhi-ye-xue-yuan.md
      - 河北工业职业技术大学: universities/he-bei-gong-ye-zhi-ye-ji-zhu-da-xue.md
      - 河北工程大学: universities/he-bei-gong-cheng-da-xue.md
      - 河北工程大学科信学院: universities/he-bei-gong-cheng-da-xue-ke-xin-xue-yuan.md
      - 河北工程技术学院: universities/he-bei-gong-cheng-ji-zhu-xue-yuan.md
      - 河北工艺美术职业学院: universities/he-bei-gong-yi-mei-shu-zhi-ye-xue-yuan.md
      - 河北师范大学: universities/he-bei-shi-fan-da-xue.md
      - 河北师范大学汇华学院: universities/he-bei-shi-fan-da-xue-hui-hua-xue-yuan.md
      - 河北建材职业技术学院: universities/he-bei-jian-cai-zhi-ye-ji-zhu-xue-yuan.md
      - 河北建筑工程学院: universities/he-bei-jian-zhu-gong-cheng-xue-yuan.md
      - 河北政法职业学院: universities/he-bei-zheng-fa-zhi-ye-xue-yuan.md
      - 河北旅游职业学院: universities/he-bei-lu-you-zhi-ye-xue-yuan.md
      - 河北民族师范学院: universities/he-bei-min-zu-shi-fan-xue-yuan.md
      - 河北水利电力学院: universities/he-bei-shui-li-dian-li-xue-yuan.md
      - 河北环境工程学院: universities/he-bei-huan-jing-gong-cheng-xue-yuan.md
      - 河北石家庄工商职业学院: universities/he-bei-shi-jia-zhuang-gong-shang-zhi-ye-xue-yuan.md
      - 河北石油职业技术大学: universities/he-bei-shi-you-zhi-ye-ji-zhu-da-xue.md
      - 河北科技大学: universities/he-bei-ke-ji-da-xue.md
      - 河北科技学院: universities/he-bei-ke-ji-xue-yuan.md
      - 河北科技工程职业技术大学: universities/he-bei-ke-ji-gong-cheng-zhi-ye-ji-zhu-da-xue.md
      - 河北科技师范学院: universities/he-bei-ke-ji-shi-fan-xue-yuan.md
      - 河北经贸大学: universities/he-bei-jing-mao-da-xue.md
      - 河北经贸大学经济管理学院: universities/he-bei-jing-mao-da-xue-jing-ji-guan-li-xue-yuan.md
      - 河北美术学院: universities/he-bei-mei-shu-xue-yuan.md
      - 河北轨道运输职业技术学院: universities/he-bei-gui-dao-yun-shu-zhi-ye-ji-zhu-xue-yuan.md
      - 河北软件职业技术学院: universities/he-bei-ruan-jian-zhi-ye-ji-zhu-xue-yuan.md
      - 河北金融学院: universities/he-bei-jin-rong-xue-yuan.md
      - 河北青年管理干部学院: universities/he-bei-qing-nian-guan-li-gan-bu-xue-yuan.md
      - 渤海理工职业学院: universities/bo-hai-li-gong-zhi-ye-xue-yuan.md
      - 燕京理工学院: universities/yan-jing-li-gong-xue-yuan.md
      - 燕山大学: universities/yan-shan-da-xue.md
      - 石家庄医学高等专科学校: universities/shi-jia-zhuang-yi-xue-gao-deng-zhuan-ke-xue-xiao.md
      - 石家庄学院: universities/shi-jia-zhuang-xue-yuan.md
      - 石家庄工商职业学院: universities/shi-jia-zhuang-gong-shang-zhi-ye-xue-yuan.md
      - 石家庄幼儿师范高等专科学校: universities/shi-jia-zhuang-you-er-shi-fan-gao-deng-zhuan-ke-xue-xiao.md
      - 石家庄科技职业学院: universities/shi-jia-zhuang-ke-ji-zhi-ye-xue-yuan.md
      - 石家庄财经职业学院: universities/shi-jia-zhuang-cai-jing-zhi-ye-xue-yuan.md
      - 石家庄邮电职业技术学院: universities/shi-jia-zhuang-you-dian-zhi-ye-ji-zhu-xue-yuan.md
      - 石家庄邮电职业技术学院东校区: universities/shi-jia-zhuang-you-dian-zhi-ye-ji-zhu-xue-yuan-dong-xiao-qu.md
      - 石家庄铁道大学: universities/shi-jia-zhuang-tie-dao-da-xue.md
      - 石家庄铁道大学四方学院: universities/shi-jia-zhuang-tie-dao-da-xue-si-fang-xue-yuan.md
      - 秦皇岛职业技术学院: universities/qin-huang-dao-zhi-ye-ji-zhu-xue-yuan.md
      - 衡水学院: universities/heng-shui-xue-yuan.md
      - 邢台医学高等专科学校: universities/xing-tai-yi-xue-gao-deng-zhuan-ke-xue-xiao.md
      - 邢台学院: universities/xing-tai-xue-yuan.md
      - 邢台应用技术职业学院: universities/xing-tai-ying-yong-ji-zhu-zhi-ye-xue-yuan.md
      - 邯郸学院: universities/han-dan-xue-yuan.md
      - 邯郸职业技术学院: universities/han-dan-zhi-ye-ji-zhu-xue-yuan.md
      - 防灾科技学院: universities/fang-zai-ke-ji-xue-yuan.md
    - 山西:
      - 中北大学: universities/zhong-bei-da-xue.md
      - 吕梁学院: universities/lu-liang-xue-yuan.md
      - 太原学院: universities/tai-yuan-xue-yuan.md
      - 太原工业学院: universities/tai-yuan-gong-ye-xue-yuan.md
      - 太原师范学院: universities/tai-yuan-shi-fan-xue-yuan.md
      - 太原理工大学: universities/tai-yuan-li-gong-da-xue.md
      - 太原理工大学明向校区: universities/tai-yuan-li-gong-da-xue-ming-xiang-xiao-qu.md
      - 太原科技大学: universities/tai-yuan-ke-ji-da-xue.md
      - 山西中医药大学: universities/shan-xi-zhong-yi-yao-da-xue-2.md
      - 山西传媒学院: universities/shan-xi-chuan-mei-xue-yuan.md
      - 山西信息职业技术学院: universities/shan-xi-xin-xi-zhi-ye-ji-zhu-xue-yuan.md
      - 山西农业大学: universities/shan-xi-nong-ye-da-xue.md
      - 山西医科大学: universities/shan-xi-yi-ke-da-xue.md
      - 山西医科大学汾阳学院: universities/shan-xi-yi-ke-da-xue-fen-yang-xue-yuan.md
      - 山西华澳商贸职业学院: universities/shan-xi-hua-ao-shang-mao-zhi-ye-xue-yuan.md
      - 山西卫生健康职业学院: universities/shan-xi-wei-sheng-jian-kang-zhi-ye-xue-yuan.md
      - 山西卫生健康职业学院康养学院: universities/shan-xi-wei-sheng-jian-kang-zhi-ye-xue-yuan-kang-yang-xue-yuan.md
      - 山西大同大学: universities/shan-xi-da-tong-da-xue.md
      - 山西大学: universities/shan-xi-da-xue.md
      - 山西工商学院: universities/shan-xi-gong-shang-xue-yuan.md
      - 山西工学院: universities/shan-xi-gong-xue-yuan.md
      - 山西工程科技职业大学: universities/shan-xi-gong-cheng-ke-ji-zhi-ye-da-xue.md
      - 山西工程职业学院: universities/shan-xi-gong-cheng-zhi-ye-xue-yuan.md
      - 山西师范大学: universities/shan-xi-shi-fan-da-xue-2.md
      - 山西应用科技学院: universities/shan-xi-ying-yong-ke-ji-xue-yuan.md
      - 山西晋中理工学院: universities/shan-xi-jin-zhong-li-gong-xue-yuan.md
      - 山西水利职业技术学院: universities/shan-xi-shui-li-zhi-ye-ji-zhu-xue-yuan.md
      - 山西省财政税务专科学校: universities/shan-xi-sheng-cai-zheng-shui-wu-zhuan-ke-xue-xiao.md
      - 山西科技学院: universities/shan-xi-ke-ji-xue-yuan.md
      - 山西经贸职业学院: universities/shan-xi-jing-mao-zhi-ye-xue-yuan.md
      - 山西能源学院: universities/shan-xi-neng-yuan-xue-yuan.md
      - 山西财经大学: universities/shan-xi-cai-jing-da-xue.md
      - 山西运城农业职业技术学院: universities/shan-xi-yun-cheng-nong-ye-zhi-ye-ji-zhu-xue-yuan.md
      - 山西通用航空职业技术学院: universities/shan-xi-tong-yong-hang-kong-zhi-ye-ji-zhu-xue-yuan.md
      - 忻州师范学院: universities/xin-zhou-shi-fan-xue-yuan.md
      - 晋中信息学院: universities/jin-zhong-xin-xi-xue-yuan.md
      - 晋中学院: universities/jin-zhong-xue-yuan.md
      - 运城学院: universities/yun-cheng-xue-yuan.md
      - 长治医学院: universities/chang-zhi-yi-xue-yuan.md
      - 长治学院: universities/chang-zhi-xue-yuan.md
    - 内蒙古:
      - 乌兰察布职业学院: universities/wu-lan-cha-bu-zhi-ye-xue-yuan.md
      - 内蒙古交通职业技术学院: universities/nei-meng-gu-jiao-tong-zhi-ye-ji-zhu-xue-yuan.md
      - 内蒙古农业大学: universities/nei-meng-gu-nong-ye-da-xue.md
      - 内蒙古医科大学: universities/nei-meng-gu-yi-ke-da-xue.md
      - 内蒙古医科大学金山校区{我的回答仅限金山校区}: universities/nei-meng-gu-yi-ke-da-xue-jin-shan-xiao-qu-wo-de-hui-da-jin-xian-jin-shan-xiao-qu.md
      - 内蒙古大学: universities/nei-meng-gu-da-xue.md
      - 内蒙古工业大学: universities/nei-meng-gu-gong-ye-da-xue.md
      - 内蒙古师范大学: universities/nei-meng-gu-shi-fan-da-xue.md
      - 内蒙古民族大学: universities/nei-meng-gu-min-zu-da-xue.md
      - 内蒙古科技大学: universities/nei-meng-gu-ke-ji-da-xue.md
      - 内蒙古科技大学包头师范学院: universities/nei-meng-gu-ke-ji-da-xue-bao-tou-shi-fan-xue-yuan.md
      - 内蒙古艺术学院: universities/nei-meng-gu-yi-zhu-xue-yuan.md
      - 内蒙古警察职业学院: universities/nei-meng-gu-jing-cha-zhi-ye-xue-yuan.md
      - 内蒙古财经大学: universities/nei-meng-gu-cai-jing-da-xue.md
      - 内蒙古鸿德文理学院: universities/nei-meng-gu-hong-de-wen-li-xue-yuan.md
      - 包头职业技术学院: universities/bao-tou-zhi-ye-ji-zhu-xue-yuan.md
      - 呼伦贝尔职业技术学院: universities/hu-lun-bei-er-zhi-ye-ji-zhu-xue-yuan.md
      - 呼和浩特职业学院: universities/hu-he-hao-te-zhi-ye-xue-yuan.md
      - 河套学院: universities/he-tao-xue-yuan.md
      - 赤峰学院: universities/chi-feng-xue-yuan.md
      - 集宁师范学院: universities/ji-zhu-shi-fan-xue-yuan.md
      - 集宁师范学院-白海校区: universities/ji-zhu-shi-fan-xue-yuan-bai-hai-xiao-qu.md
    - 辽宁:
      - 东北大学: universities/dong-bei-da-xue.md
      - 东北大学浑南校区: universities/dong-bei-da-xue-hun-nan-xiao-qu.md
      - 东北财经大学: universities/dong-bei-cai-jing-da-xue.md
      - 中国刑事警察学院: universities/zhong-guo-xing-shi-jing-cha-xue-yuan.md
      - 中国医科大学: universities/zhong-guo-yi-ke-da-xue.md
      - 大连东软信息学院: universities/da-lian-dong-ruan-xin-xi-xue-yuan.md
      - 大连交通大学: universities/da-lian-jiao-tong-da-xue.md
      - 大连交通大学旅顺校区: universities/da-lian-jiao-tong-da-xue-lu-shun-xiao-qu.md
      - 大连医科大学: universities/da-lian-yi-ke-da-xue.md
      - 大连医科大学中山学院: universities/da-lian-yi-ke-da-xue-zhong-shan-xue-yuan.md
      - 大连外国语大学: universities/da-lian-wai-guo-yu-da-xue.md
      - 大连大学: universities/da-lian-da-xue.md
      - 大连工业大学: universities/da-lian-gong-ye-da-xue.md
      - 大连工业大学艺术与信息工程学院: universities/da-lian-gong-ye-da-xue-yi-zhu-yu-xin-xi-gong-cheng-xue-yuan.md
      - 大连工业大学艺术与工程信息学院: universities/da-lian-gong-ye-da-xue-yi-zhu-yu-gong-cheng-xin-xi-xue-yuan.md
      - 大连民族大学: universities/da-lian-min-zu-da-xue.md
      - 大连海事大学: universities/da-lian-hai-shi-da-xue.md
      - 大连海洋大学: universities/da-lian-hai-yang-da-xue.md
      - 大连理工大学: universities/da-lian-li-gong-da-xue.md
      - 大连理工大学城市学院: universities/da-lian-li-gong-da-xue-cheng-shi-xue-yuan.md
      - 大连理工大学开发区校区: universities/da-lian-li-gong-da-xue-kai-fa-qu-xiao-qu.md
      - 大连理工大学盘锦校区: universities/da-lian-li-gong-da-xue-pan-jin-xiao-qu.md
      - 大连科技学院: universities/da-lian-ke-ji-xue-yuan.md
      - 大连艺术学院: universities/da-lian-yi-zhu-xue-yuan.md
      - 抚顺师范高等专科学校: universities/fu-shun-shi-fan-gao-deng-zhuan-ke-xue-xiao.md
      - 沈阳农业大学: universities/chen-yang-nong-ye-da-xue.md
      - 沈阳化工大学: universities/chen-yang-hua-gong-da-xue.md
      - 沈阳北软信息职业技术学院: universities/chen-yang-bei-ruan-xin-xi-zhi-ye-ji-zhu-xue-yuan.md
      - 沈阳医学院: universities/chen-yang-yi-xue-yuan.md
      - 沈阳城市学院: universities/chen-yang-cheng-shi-xue-yuan.md
      - 沈阳城市建设学院: universities/chen-yang-cheng-shi-jian-she-xue-yuan.md
      - 沈阳大学: universities/chen-yang-da-xue.md
      - 沈阳工业大学: universities/chen-yang-gong-ye-da-xue.md
      - 沈阳工学院: universities/chen-yang-gong-xue-yuan.md
      - 沈阳工程学院: universities/chen-yang-gong-cheng-xue-yuan.md
      - 沈阳师范大学: universities/chen-yang-shi-fan-da-xue.md
      - 沈阳建筑大学: universities/chen-yang-jian-zhu-da-xue.md
      - 沈阳理工大学: universities/chen-yang-li-gong-da-xue.md
      - 沈阳职业技术学院: universities/chen-yang-zhi-ye-ji-zhu-xue-yuan.md
      - 沈阳航空航天大学: universities/chen-yang-hang-kong-hang-tian-da-xue.md
      - 沈阳药科大学: universities/chen-yang-yao-ke-da-xue.md
      - 沈阳音乐学院: universities/chen-yang-yin-le-xue-yuan.md
      - 渤海大学: universities/bo-hai-da-xue.md
      - 渤海船舶职业学院: universities/bo-hai-chuan-bo-zhi-ye-xue-yuan.md
      - 营口理工学院: universities/ying-kou-li-gong-xue-yuan.md
      - 营口职业技术学院: universities/ying-kou-zhi-ye-ji-zhu-xue-yuan.md
      - 辽东学院: universities/liao-dong-xue-yuan.md
      - 辽宁中医药大学: universities/liao-zhu-zhong-yi-yao-da-xue.md
      - 辽宁中医药大学杏林学院: universities/liao-zhu-zhong-yi-yao-da-xue-xing-lin-xue-yuan.md
      - 辽宁传媒学院: universities/liao-zhu-chuan-mei-xue-yuan.md
      - 辽宁何氏医学院: universities/liao-zhu-he-shi-yi-xue-yuan.md
      - 辽宁农业职业技术学院: universities/liao-zhu-nong-ye-zhi-ye-ji-zhu-xue-yuan.md
      - 辽宁冶金职业技术学院: universities/liao-zhu-ye-jin-zhi-ye-ji-zhu-xue-yuan.md
      - 辽宁地质工程职业学院: universities/liao-zhu-di-zhi-gong-cheng-zhi-ye-xue-yuan.md
      - 辽宁大学: universities/liao-zhu-da-xue.md
      - 辽宁大学崇山校区: universities/liao-zhu-da-xue-chong-shan-xiao-qu.md
      - 辽宁大学蒲河校区: universities/liao-zhu-da-xue-pu-he-xiao-qu.md
      - 辽宁对外经贸学院: universities/liao-zhu-dui-wai-jing-mao-xue-yuan.md
      - 辽宁工业大学: universities/liao-zhu-gong-ye-da-xue.md
      - 辽宁工程技术大学: universities/liao-zhu-gong-cheng-ji-zhu-da-xue.md
      - 辽宁工程技术大学玉龙校区: universities/liao-zhu-gong-cheng-ji-zhu-da-xue-yu-long-xiao-qu.md
      - 辽宁工程职业学院: universities/liao-zhu-gong-cheng-zhi-ye-xue-yuan.md
      - 辽宁师范大学: universities/liao-zhu-shi-fan-da-xue.md
      - 辽宁师范大学海华学院: universities/liao-zhu-shi-fan-da-xue-hai-hua-xue-yuan.md
      - 辽宁师范大学西山湖校区: universities/liao-zhu-shi-fan-da-xue-xi-shan-hu-xiao-qu.md
      - 辽宁建筑职业学院: universities/liao-zhu-jian-zhu-zhi-ye-xue-yuan.md
      - 辽宁机电职业技术学院: universities/liao-zhu-ji-dian-zhi-ye-ji-zhu-xue-yuan.md
      - 辽宁特殊教育师范高等专科学校: universities/liao-zhu-te-shu-jiao-yu-shi-fan-gao-deng-zhuan-ke-xue-xiao.md
      - 辽宁理工学院: universities/liao-zhu-li-gong-xue-yuan.md
      - 辽宁省交通高等专科学校: universities/liao-zhu-sheng-jiao-tong-gao-deng-zhuan-ke-xue-xiao.md
      - 辽宁石油化工大学: universities/liao-zhu-shi-you-hua-gong-da-xue.md
      - 辽宁科技大学: universities/liao-zhu-ke-ji-da-xue.md
      - 辽宁科技学院: universities/liao-zhu-ke-ji-xue-yuan.md
      - 辽宁装备制造职业技术学院: universities/liao-zhu-zhuang-bei-zhi-zao-zhi-ye-ji-zhu-xue-yuan.md
      - 辽宁警察学院: universities/liao-zhu-jing-cha-xue-yuan.md
      - 辽宁金融职业学院: universities/liao-zhu-jin-rong-zhi-ye-xue-yuan.md
      - 辽宁铁道职业技术学院: universities/liao-zhu-tie-dao-zhi-ye-ji-zhu-xue-yuan.md
      - 铁岭师范高等专科学校: universities/tie-ling-shi-fan-gao-deng-zhuan-ke-xue-xiao.md
      - 锦州医科大学: universities/jin-zhou-yi-ke-da-xue.md
      - 锦州医科大学医疗学院: universities/jin-zhou-yi-ke-da-xue-yi-liao-xue-yuan.md
      - 锦州师范高等专科学校: universities/jin-zhou-shi-fan-gao-deng-zhuan-ke-xue-xiao.md
      - 鞍山职业技术学院: universities/an-shan-zhi-ye-ji-zhu-xue-yuan.md
      - 鲁迅美术学院大连校区: universities/lu-xun-mei-shu-xue-yuan-da-lian-xiao-qu.md
    - 吉林:
      - 东北师范大学: universities/dong-bei-shi-fan-da-xue.md
      - 东北师范大学净月校区: universities/dong-bei-shi-fan-da-xue-jing-yue-xiao-qu.md
      - 东北电力大学: universities/dong-bei-dian-li-da-xue.md
      - 北华大学: universities/bei-hua-da-xue.md
      - 吉林农业大学: universities/ji-lin-nong-ye-da-xue.md
      - 吉林农业科技学院: universities/ji-lin-nong-ye-ke-ji-xue-yuan.md
      - 吉林动画学院: universities/ji-lin-dong-hua-xue-yuan.md
      - 吉林化工学院: universities/ji-lin-hua-gong-xue-yuan.md
      - 吉林医药学院: universities/ji-lin-yi-yao-xue-yuan.md
      - 吉林外国语大学: universities/ji-lin-wai-guo-yu-da-xue.md
      - 吉林大学: universities/ji-lin-da-xue.md
      - 吉林大学前卫南区: universities/ji-lin-da-xue-qian-wei-nan-qu.md
      - 吉林大学南岭校区: universities/ji-lin-da-xue-nan-ling-xiao-qu.md
      - 吉林大学南湖校区: universities/ji-lin-da-xue-nan-hu-xiao-qu.md
      - 吉林大学和平校区: universities/ji-lin-da-xue-he-ping-xiao-qu.md
      - 吉林大学朝阳校区: universities/ji-lin-da-xue-zhao-yang-xiao-qu.md
      - 吉林大学白求恩临床医学院: universities/ji-lin-da-xue-bai-qiu-en-lin-chuang-yi-xue-yuan.md
      - 吉林工商学院: universities/ji-lin-gong-shang-xue-yuan.md
      - 吉林工程技术师范学院: universities/ji-lin-gong-cheng-ji-zhu-shi-fan-xue-yuan.md
      - 吉林工程职业学院: universities/ji-lin-gong-cheng-zhi-ye-xue-yuan.md
      - 吉林师范大学: universities/ji-lin-shi-fan-da-xue.md
      - 吉林师范大学博达学院: universities/ji-lin-shi-fan-da-xue-bo-da-xue-yuan.md
      - 吉林师范大学四平总校区: universities/ji-lin-shi-fan-da-xue-si-ping-zong-xiao-qu.md
      - 吉林师范大学四平校区: universities/ji-lin-shi-fan-da-xue-si-ping-xiao-qu.md
      - 吉林师范大学本院: universities/ji-lin-shi-fan-da-xue-ben-yuan.md
      - 吉林建筑大学: universities/ji-lin-jian-zhu-da-xue.md
      - 吉林建筑科技学院: universities/ji-lin-jian-zhu-ke-ji-xue-yuan.md
      - 吉林电子信息职业技术学院: universities/ji-lin-dian-zi-xin-xi-zhi-ye-ji-zhu-xue-yuan.md
      - 吉林艺术学院综合校区: universities/ji-lin-yi-zhu-xue-yuan-zong-he-xiao-qu.md
      - 吉林财经大学: universities/ji-lin-cai-jing-da-xue.md
      - 吉林铁道职业技术学院: universities/ji-lin-tie-dao-zhi-ye-ji-zhu-xue-yuan.md
      - 延边大学: universities/yan-bian-da-xue.md
      - 延边大学珲春校区: universities/yan-bian-da-xue-hun-chun-xiao-qu.md
      - 松原职业技术学院: universities/song-yuan-zhi-ye-ji-zhu-xue-yuan.md
      - 梅河口康美职业技术学院: universities/mei-he-kou-kang-mei-zhi-ye-ji-zhu-xue-yuan.md
      - 白城师范学院: universities/bai-cheng-shi-fan-xue-yuan.md
      - 空军航空大学: universities/kong-jun-hang-kong-da-xue.md
      - 辽源职业技术学院: universities/liao-yuan-zhi-ye-ji-zhu-xue-yuan.md
      - 通化师范学院: universities/tong-hua-shi-fan-xue-yuan.md
      - 长春中医药大学: universities/chang-chun-zhong-yi-yao-da-xue.md
      - 长春人文学院: universities/chang-chun-ren-wen-xue-yuan.md
      - 长春光华学院: universities/chang-chun-guang-hua-xue-yuan.md
      - 长春医学高等专科学校: universities/chang-chun-yi-xue-gao-deng-zhuan-ke-xue-xiao.md
      - 长春大学: universities/chang-chun-da-xue.md
      - 长春大学旅游学院: universities/chang-chun-da-xue-lu-you-xue-yuan.md
      - 长春工业大学: universities/chang-chun-gong-ye-da-xue.md
      - 长春工业大学人文信息学院: universities/chang-chun-gong-ye-da-xue-ren-wen-xin-xi-xue-yuan.md
      - 长春工业大学北湖东区: universities/chang-chun-gong-ye-da-xue-bei-hu-dong-qu.md
      - 长春工程学院: universities/chang-chun-gong-cheng-xue-yuan.md
      - 长春师范大学: universities/chang-chun-shi-fan-da-xue.md
      - 长春建筑学院: universities/chang-chun-jian-zhu-xue-yuan.md
      - 长春汽车工业高等专科学校: universities/chang-chun-qi-che-gong-ye-gao-deng-zhuan-ke-xue-xiao.md
      - 长春理工大学: universities/chang-chun-li-gong-da-xue.md
      - 长春电子科技学院: universities/chang-chun-dian-zi-ke-ji-xue-yuan.md
      - 长春财经学院: universities/chang-chun-cai-jing-xue-yuan.md
      - 长春金融高等专科学校: universities/chang-chun-jin-rong-gao-deng-zhuan-ke-xue-xiao.md
    - 黑龙江:
      - 东北农业大学: universities/dong-bei-nong-ye-da-xue.md
      - 东北林业大学: universities/dong-bei-lin-ye-da-xue.md
      - 东北石油大学: universities/dong-bei-shi-you-da-xue.md
      - 伊春职业学院: universities/yi-chun-zhi-ye-xue-yuan.md
      - 佳木斯大学: universities/jia-mu-si-da-xue.md
      - 哈尔滨信息工程学院: universities/ha-er-bin-xin-xi-gong-cheng-xue-yuan.md
      - 哈尔滨剑桥学院: universities/ha-er-bin-jian-qiao-xue-yuan.md
      - 哈尔滨医科大学: universities/ha-er-bin-yi-ke-da-xue.md
      - 哈尔滨医科大学大庆校区: universities/ha-er-bin-yi-ke-da-xue-da-qing-xiao-qu.md
      - 哈尔滨华德学院: universities/ha-er-bin-hua-de-xue-yuan.md
      - 哈尔滨商业大学: universities/ha-er-bin-shang-ye-da-xue.md
      - 哈尔滨工业大学: universities/ha-er-bin-gong-ye-da-xue.md
      - 哈尔滨工程大学: universities/ha-er-bin-gong-cheng-da-xue.md
      - 哈尔滨师范大学: universities/ha-er-bin-shi-fan-da-xue.md
      - 哈尔滨师范大学松北校区: universities/ha-er-bin-shi-fan-da-xue-song-bei-xiao-qu.md
      - 哈尔滨师范大学江南校区: universities/ha-er-bin-shi-fan-da-xue-jiang-nan-xiao-qu.md
      - 哈尔滨广厦学院: universities/ha-er-bin-yan-sha-xue-yuan.md
      - 哈尔滨理工大学: universities/ha-er-bin-li-gong-da-xue.md
      - 哈尔滨理工大学荣成校区: universities/ha-er-bin-li-gong-da-xue-rong-cheng-xiao-qu.md
      - 哈尔滨石油学院: universities/ha-er-bin-shi-you-xue-yuan.md
      - 哈尔滨职业技术学院: universities/ha-er-bin-zhi-ye-ji-zhu-xue-yuan.md
      - 哈尔滨职业技术学院哈尔滨职业技术大学: universities/ha-er-bin-zhi-ye-ji-zhu-xue-yuan-ha-er-bin-zhi-ye-ji-zhu-da-xue.md
      - 哈尔滨远东理工学院: universities/ha-er-bin-yuan-dong-li-gong-xue-yuan.md
      - 哈尔滨金融学院: universities/ha-er-bin-jin-rong-xue-yuan.md
      - 哈尔滨铁道职业技术学院: universities/ha-er-bin-tie-dao-zhi-ye-ji-zhu-xue-yuan.md
      - 大庆师范学院: universities/da-qing-shi-fan-xue-yuan.md
      - 牡丹江医学院: universities/mu-dan-jiang-yi-xue-yuan.md
      - 牡丹江医学院牡丹江医科大学: universities/mu-dan-jiang-yi-xue-yuan-mu-dan-jiang-yi-ke-da-xue.md
      - 牡丹江大学: universities/mu-dan-jiang-da-xue.md
      - 牡丹江师范学院: universities/mu-dan-jiang-shi-fan-xue-yuan.md
      - 绥化学院: universities/sui-hua-xue-yuan.md
      - 黑河学院: universities/hei-he-xue-yuan.md
      - 黑龙江三江美术职业学院: universities/hei-long-jiang-san-jiang-mei-shu-zhi-ye-xue-yuan.md
      - 黑龙江东方学院: universities/hei-long-jiang-dong-fang-xue-yuan.md
      - 黑龙江中医药大学: universities/hei-long-jiang-zhong-yi-yao-da-xue.md
      - 黑龙江八一农垦大学: universities/hei-long-jiang-ba-yi-nong-ken-da-xue.md
      - 黑龙江农业工程职业学院: universities/hei-long-jiang-nong-ye-gong-cheng-zhi-ye-xue-yuan.md
      - 黑龙江农业经济职业学院: universities/hei-long-jiang-nong-ye-jing-ji-zhi-ye-xue-yuan.md
      - 黑龙江农业职业技术学院: universities/hei-long-jiang-nong-ye-zhi-ye-ji-zhu-xue-yuan.md
      - 黑龙江农垦职业学院宾西校区: universities/hei-long-jiang-nong-ken-zhi-ye-xue-yuan-bin-xi-xiao-qu.md
      - 黑龙江冰雪体育职业学院: universities/hei-long-jiang-bing-xue-ti-yu-zhi-ye-xue-yuan.md
      - 黑龙江司法警官职业学院: universities/hei-long-jiang-si-fa-jing-guan-zhi-ye-xue-yuan.md
      - 黑龙江外国语学院: universities/hei-long-jiang-wai-guo-yu-xue-yuan.md
      - 黑龙江大学: universities/hei-long-jiang-da-xue.md
      - 黑龙江工商学院: universities/hei-long-jiang-gong-shang-xue-yuan.md
      - 黑龙江工程学院: universities/hei-long-jiang-gong-cheng-xue-yuan.md
      - 黑龙江工程学院昆仑旅游学院: universities/hei-long-jiang-gong-cheng-xue-yuan-kun-lun-lu-you-xue-yuan.md
      - 黑龙江建筑职业技术学院: universities/hei-long-jiang-jian-zhu-zhi-ye-ji-zhu-xue-yuan.md
      - 黑龙江护理高等专科学校南岗校区: universities/hei-long-jiang-hu-li-gao-deng-zhuan-ke-xue-xiao-nan-gang-xiao-qu.md
      - 黑龙江林业职业技术学院: universities/hei-long-jiang-lin-ye-zhi-ye-ji-zhu-xue-yuan.md
      - 黑龙江民族职业学院: universities/hei-long-jiang-min-zu-zhi-ye-xue-yuan.md
      - 黑龙江科技大学: universities/hei-long-jiang-ke-ji-da-xue.md
      - 黑龙江职业学院: universities/hei-long-jiang-zhi-ye-xue-yuan.md
      - 齐齐哈尔医学院: universities/qi-qi-ha-er-yi-xue-yuan.md
      - 齐齐哈尔大学: universities/qi-qi-ha-er-da-xue.md
      - 齐齐哈尔工程学院: universities/qi-qi-ha-er-gong-cheng-xue-yuan.md
      - 齐齐哈尔高等师范专科学校: universities/qi-qi-ha-er-gao-deng-shi-fan-zhuan-ke-xue-xiao.md
    - 上海:
      - -上海健康医学院: universities/shang-hai-jian-kang-yi-xue-yuan-2.md
      - 上海中侨职业技术大学: universities/shang-hai-zhong-qiao-zhi-ye-ji-zhu-da-xue.md
      - 上海中医药大学: universities/shang-hai-zhong-yi-yao-da-xue.md
      - 上海交通大学: universities/shang-hai-jiao-tong-da-xue.md
      - 上海交通职业技术学院闵行校区轨道交通学院: universities/shang-hai-jiao-tong-zhi-ye-ji-zhu-xue-yuan-min-xing-xiao-qu-gui-dao-jiao-tong-xue-yuan.md
      - 上海健康医学院: universities/shang-hai-jian-kang-yi-xue-yuan.md
      - 上海健康医学院南苑: universities/shang-hai-jian-kang-yi-xue-yuan-nan-yuan.md
      - 上海农林职业技术学院: universities/shang-hai-nong-lin-zhi-ye-ji-zhu-xue-yuan.md
      - 上海商学院: universities/shang-hai-shang-xue-yuan.md
      - 上海商学院赤峰路: universities/shang-hai-shang-xue-yuan-chi-feng-lu.md
      - 上海城建职业学院: universities/shang-hai-cheng-jian-zhi-ye-xue-yuan.md
      - 上海城建职业学院 我目前在奉贤校区 提供的是奉贤校区的信息哦: universities/shang-hai-cheng-jian-zhi-ye-xue-yuan-wo-mu-qian-zai-feng-xian-xiao-qu-ti-gong-de-shi-feng-xian-xiao-qu-de-xin-xi-e.md
      - 上海外国语大学: universities/shang-hai-wai-guo-yu-da-xue.md
      - 上海大学: universities/shang-hai-da-xue.md
      - 上海大学宝山校区: universities/shang-hai-da-xue-bao-shan-xiao-qu.md
      - 上海对外经贸大学: universities/shang-hai-dui-wai-jing-mao-da-xue.md
      - 上海工商外国语职业学院: universities/shang-hai-gong-shang-wai-guo-yu-zhi-ye-xue-yuan.md
      - 上海工程技术大学: universities/shang-hai-gong-cheng-ji-zhu-da-xue.md
      - 上海师范大学: universities/shang-hai-shi-fan-da-xue.md
      - 上海师范大学天华学院: universities/shang-hai-shi-fan-da-xue-tian-hua-xue-yuan.md
      - 上海师范大学徐汇校区: universities/shang-hai-shi-fan-da-xue-xu-hui-xiao-qu.md
      - 上海应用技术大学: universities/shang-hai-ying-yong-ji-zhu-da-xue.md
      - 上海应用技术大学徐汇校区: universities/shang-hai-ying-yong-ji-zhu-da-xue-xu-hui-xiao-qu.md
      - 上海建桥学院: universities/shang-hai-jian-qiao-xue-yuan.md
      - 上海戏剧学院: universities/shang-hai-xi-ju-xue-yuan.md
      - 上海政法学院: universities/shang-hai-zheng-fa-xue-yuan.md
      - 上海杉达学院: universities/shang-hai-shan-da-xue-yuan.md
      - 上海民航职业技术学院: universities/shang-hai-min-hang-zhi-ye-ji-zhu-xue-yuan.md
      - 上海民远职业技术学院: universities/shang-hai-min-yuan-zhi-ye-ji-zhu-xue-yuan.md
      - 上海海事大学: universities/shang-hai-hai-shi-da-xue.md
      - 上海海关学院: universities/shang-hai-hai-guan-xue-yuan.md
      - 上海海洋大学: universities/shang-hai-hai-yang-da-xue.md
      - 上海理工大学: universities/shang-hai-li-gong-da-xue.md
      - 上海电力大学: universities/shang-hai-dian-li-da-xue.md
      - 上海电力大学杨浦校区: universities/shang-hai-dian-li-da-xue-yang-pu-xiao-qu.md
      - 上海电机学院: universities/shang-hai-dian-ji-xue-yuan.md
      - 上海科技大学: universities/shang-hai-ke-ji-da-xue.md
      - 上海立信会计金融学院: universities/shang-hai-li-xin-hui-ji-jin-rong-xue-yuan.md
      - 上海立达学院: universities/shang-hai-li-da-xue-yuan.md
      - 上海第二工业大学: universities/shang-hai-di-er-gong-ye-da-xue.md
      - 上海纽约大学: universities/shang-hai-niu-yue-da-xue.md
      - 上海行健职业学院: universities/shang-hai-xing-jian-zhi-ye-xue-yuan.md
      - 上海视觉艺术学院: universities/shang-hai-shi-jue-yi-zhu-xue-yuan.md
      - 上海财经大学: universities/shang-hai-cai-jing-da-xue.md
      - 上海震旦职业学院: universities/shang-hai-zhen-dan-zhi-ye-xue-yuan.md
      - 东华大学: universities/dong-hua-da-xue.md
      - 华东师范大学: universities/hua-dong-shi-fan-da-xue.md
      - 华东师范大学中北校区: universities/hua-dong-shi-fan-da-xue-zhong-bei-xiao-qu.md
      - 华东政法大学: universities/hua-dong-zheng-fa-da-xue.md
      - 华东理工大学: universities/hua-dong-li-gong-da-xue.md
      - 同济大学: universities/tong-ji-da-xue.md
      - 复旦大学: universities/fu-dan-da-xue.md
      - 海军军医大学: universities/hai-jun-jun-yi-da-xue.md
    - 江苏:
      - 三江学院: universities/san-jiang-xue-yuan.md
      - 东南大学: universities/dong-nan-da-xue.md
      - 东南大学四牌楼校区: universities/dong-nan-da-xue-si-pai-lou-xiao-qu.md
      - 东南大学成贤学院: universities/dong-nan-da-xue-cheng-xian-xue-yuan.md
      - 中国人民大学苏州校区: universities/zhong-guo-ren-min-da-xue-su-zhou-xiao-qu.md
      - 中国矿业大学: universities/zhong-guo-kuang-ye-da-xue.md
      - 中国矿业大学徐海学院: universities/zhong-guo-kuang-ye-da-xue-xu-hai-xue-yuan.md
      - 中国矿业大学银川学院: universities/zhong-guo-kuang-ye-da-xue-yin-chuan-xue-yuan.md
      - 中国药科大学: universities/zhong-guo-yao-ke-da-xue.md
      - 九州职业技术学院: universities/jiu-zhou-zhi-ye-ji-zhu-xue-yuan.md
      - 南京中医药大学: universities/nan-jing-zhong-yi-yao-da-xue.md
      - 南京中医药大学仙林校区: universities/nan-jing-zhong-yi-yao-da-xue-xian-lin-xiao-qu.md
      - 南京中医药大学泰州校区: universities/nan-jing-zhong-yi-yao-da-xue-tai-zhou-xiao-qu.md
      - 南京交通职业技术学院: universities/nan-jing-jiao-tong-zhi-ye-ji-zhu-xue-yuan.md
      - 南京传媒学院: universities/nan-jing-chuan-mei-xue-yuan.md
      - 南京体育学院仙林校区: universities/nan-jing-ti-yu-xue-yuan-xian-lin-xiao-qu.md
      - 南京信息工程大学: universities/nan-jing-xin-xi-gong-cheng-da-xue.md
      - 南京信息职业技术学院: universities/nan-jing-xin-xi-zhi-ye-ji-zhu-xue-yuan.md
      - 南京农业大学: universities/nan-jing-nong-ye-da-xue.md
      - 南京农业大学仅卫岗校区: universities/nan-jing-nong-ye-da-xue-jin-wei-gang-xiao-qu.md
      - 南京农业大学卫岗校区: universities/nan-jing-nong-ye-da-xue-wei-gang-xiao-qu.md
      - 南京农业大学工学院: universities/nan-jing-nong-ye-da-xue-gong-xue-yuan.md
      - 南京农业大学浦口校区南京农业大学工学院: universities/nan-jing-nong-ye-da-xue-pu-kou-xiao-qu-nan-jing-nong-ye-da-xue-gong-xue-yuan.md
      - 南京医科大学: universities/nan-jing-yi-ke-da-xue.md
      - 南京医科大学康法学院: universities/nan-jing-yi-ke-da-xue-kang-fa-xue-yuan.md
      - 南京医科大学康达学院: universities/nan-jing-yi-ke-da-xue-kang-da-xue-yuan.md
      - 南京大学: universities/nan-jing-da-xue.md
      - 南京大学仙林校区: universities/nan-jing-da-xue-xian-lin-xiao-qu.md
      - 南京审计大学: universities/nan-jing-shen-ji-da-xue.md
      - 南京审计大学金审学院: universities/nan-jing-shen-ji-da-xue-jin-shen-xue-yuan.md
      - 南京工业大学: universities/nan-jing-gong-ye-da-xue.md
      - 南京工程学院: universities/nan-jing-gong-cheng-xue-yuan.md
      - 南京师范大学: universities/nan-jing-shi-fan-da-xue.md
      - 南京师范大学中北学院: universities/nan-jing-shi-fan-da-xue-zhong-bei-xue-yuan.md
      - 南京师范大学仙林校区: universities/nan-jing-shi-fan-da-xue-xian-lin-xiao-qu.md
      - 南京师范大学泰州学院: universities/nan-jing-shi-fan-da-xue-tai-zhou-xue-yuan.md
      - 南京晓庄学院: universities/nan-jing-xiao-zhuang-xue-yuan.md
      - 南京林业大学: universities/nan-jing-lin-ye-da-xue.md
      - 南京林业大学淮安校区: universities/nan-jing-lin-ye-da-xue-huai-an-xiao-qu.md
      - 南京理工大学: universities/nan-jing-li-gong-da-xue.md
      - 南京理工大学江阴校区: universities/nan-jing-li-gong-da-xue-jiang-yin-xiao-qu.md
      - 南京理工大学泰州科技学院: universities/nan-jing-li-gong-da-xue-tai-zhou-ke-ji-xue-yuan.md
      - 南京理工大学紫金学院: universities/nan-jing-li-gong-da-xue-zi-jin-xue-yuan.md
      - 南京科技职业学院: universities/nan-jing-ke-ji-zhi-ye-xue-yuan.md
      - 南京航空航天大学: universities/nan-jing-hang-kong-hang-tian-da-xue.md
      - 南京航空航天大学天目湖校区: universities/nan-jing-hang-kong-hang-tian-da-xue-tian-mu-hu-xiao-qu.md
      - 南京航空航天大学金城学院: universities/nan-jing-hang-kong-hang-tian-da-xue-jin-cheng-xue-yuan.md
      - 南京艺术学院: universities/nan-jing-yi-zhu-xue-yuan.md
      - 南京财经大学: universities/nan-jing-cai-jing-da-xue.md
      - 南京财经大学仙林校区: universities/nan-jing-cai-jing-da-xue-xian-lin-xiao-qu.md
      - 南京财经大学红山学院: universities/nan-jing-cai-jing-da-xue-hong-shan-xue-yuan.md
      - 南京邮电大学: universities/nan-jing-you-dian-da-xue.md
      - 南京邮电大学仙林校区: universities/nan-jing-you-dian-da-xue-xian-lin-xiao-qu.md
      - 南京邮电大学通达学院: universities/nan-jing-you-dian-da-xue-tong-da-xue-yuan.md
      - 南京铁道职业技术学院: universities/nan-jing-tie-dao-zhi-ye-ji-zhu-xue-yuan.md
      - 南通大学: universities/nan-tong-da-xue.md
      - 南通大学医学院: universities/nan-tong-da-xue-yi-xue-yuan.md
      - 南通大学杏林学院: universities/nan-tong-da-xue-xing-lin-xue-yuan.md
      - 南通师范高等专科学校: universities/nan-tong-shi-fan-gao-deng-zhuan-ke-xue-xiao.md
      - 南通理工学院: universities/nan-tong-li-gong-xue-yuan.md
      - 宿迁学院: universities/su-qian-xue-yuan.md
      - 常州信息职业技术学院: universities/chang-zhou-xin-xi-zhi-ye-ji-zhu-xue-yuan.md
      - 常州大学: universities/chang-zhou-da-xue.md
      - 常州大学怀德学院: universities/chang-zhou-da-xue-huai-de-xue-yuan.md
      - 常州工学院: universities/chang-zhou-gong-xue-yuan.md
      - 常州工程职业技术学院: universities/chang-zhou-gong-cheng-zhi-ye-ji-zhu-xue-yuan.md
      - 常州机电职业技术学院: universities/chang-zhou-ji-dian-zhi-ye-ji-zhu-xue-yuan.md
      - 常州纺织服装职业技术学院: universities/chang-zhou-fang-zhi-fu-zhuang-zhi-ye-ji-zhu-xue-yuan.md
      - 常熟理工学院: universities/chang-shou-li-gong-xue-yuan.md
      - 徐州医科大学: universities/xu-zhou-yi-ke-da-xue.md
      - 徐州工程学院: universities/xu-zhou-gong-cheng-xue-yuan.md
      - 徐州生物工程职业技术学院: universities/xu-zhou-sheng-wu-gong-cheng-zhi-ye-ji-zhu-xue-yuan.md
      - 徐州生物工程职业技术学院沛县校区！沛县校区: universities/xu-zhou-sheng-wu-gong-cheng-zhi-ye-ji-zhu-xue-yuan-pei-xian-xiao-qu-pei-xian-xiao-qu.md
      - 扬州中瑞酒店职业学院: universities/yang-zhou-zhong-rui-jiu-dian-zhi-ye-xue-yuan.md
      - 扬州大学: universities/yang-zhou-da-xue.md
      - 扬州大学广陵学院: universities/yang-zhou-da-xue-yan-ling-xue-yuan.md
      - 扬州大学瘦西湖校区: universities/yang-zhou-da-xue-shou-xi-hu-xiao-qu.md
      - 扬州工业职业技术学院: universities/yang-zhou-gong-ye-zhi-ye-ji-zhu-xue-yuan.md
      - 扬州市职业大学: universities/yang-zhou-shi-zhi-ye-da-xue.md
      - 无锡南洋职业技术学院: universities/wu-xi-nan-yang-zhi-ye-ji-zhu-xue-yuan.md
      - 无锡商业职业技术学院: universities/wu-xi-shang-ye-zhi-ye-ji-zhu-xue-yuan.md
      - 无锡太湖学院: universities/wu-xi-tai-hu-xue-yuan.md
      - 无锡学院: universities/wu-xi-xue-yuan.md
      - 无锡科技职业学院: universities/wu-xi-ke-ji-zhi-ye-xue-yuan.md
      - 无锡职业技术学院: universities/wu-xi-zhi-ye-ji-zhu-xue-yuan.md
      - 昆山杜克大学: universities/kun-shan-du-ke-da-xue.md
      - 明达职业技术学院: universities/ming-da-zhi-ye-ji-zhu-xue-yuan.md
      - 江南大学: universities/jiang-nan-da-xue.md
      - 江南影视艺术职业学院: universities/jiang-nan-ying-shi-yi-zhu-zhi-ye-xue-yuan.md
      - 江海职业技术学院: universities/jiang-hai-zhi-ye-ji-zhu-xue-yuan.md
      - 江苏信息职业技术学院: universities/jiang-su-xin-xi-zhi-ye-ji-zhu-xue-yuan.md
      - 江苏农林职业技术学院: universities/jiang-su-nong-lin-zhi-ye-ji-zhu-xue-yuan.md
      - 江苏农牧科技职业学院: universities/jiang-su-nong-mu-ke-ji-zhi-ye-xue-yuan.md
      - 江苏医药职业学院: universities/jiang-su-yi-yao-zhi-ye-xue-yuan.md
      - 江苏商贸职业学院: universities/jiang-su-shang-mao-zhi-ye-xue-yuan.md
      - 江苏城乡建设职业学院: universities/jiang-su-cheng-xiang-jian-she-zhi-ye-xue-yuan.md
      - 江苏城市职业学院: universities/jiang-su-cheng-shi-zhi-ye-xue-yuan.md
      - 江苏大学: universities/jiang-su-da-xue.md
      - 江苏大学京江学院: universities/jiang-su-da-xue-jing-jiang-xue-yuan.md
      - 江苏工程职业技术学院: universities/jiang-su-gong-cheng-zhi-ye-ji-zhu-xue-yuan.md
      - 江苏师范大学: universities/jiang-su-shi-fan-da-xue.md
      - 江苏师范大学科文学院: universities/jiang-su-shi-fan-da-xue-ke-wen-xue-yuan.md
      - 江苏建筑职业技术学院: universities/jiang-su-jian-zhu-zhi-ye-ji-zhu-xue-yuan.md
      - 江苏护理职业学院: universities/jiang-su-hu-li-zhi-ye-xue-yuan.md
      - 江苏旅游职业学院: universities/jiang-su-lu-you-zhi-ye-xue-yuan.md
      - 江苏海洋大学: universities/jiang-su-hai-yang-da-xue.md
      - 江苏理工学院: universities/jiang-su-li-gong-xue-yuan.md
      - 江苏科技大学: universities/jiang-su-ke-ji-da-xue.md
      - 江苏科技大学张家港校区: universities/jiang-su-ke-ji-da-xue-zhang-jia-gang-xiao-qu.md
      - 江苏科技大学苏州理工学院: universities/jiang-su-ke-ji-da-xue-su-zhou-li-gong-xue-yuan.md
      - 江苏第二师范学院: universities/jiang-su-di-er-shi-fan-xue-yuan.md
      - 江苏航空职业技术学院: universities/jiang-su-hang-kong-zhi-ye-ji-zhu-xue-yuan.md
      - 江苏财会职业学院: universities/jiang-su-cai-hui-zhi-ye-xue-yuan.md
      - 江苏食品药品职业技术学院: universities/jiang-su-shi-pin-yao-pin-zhi-ye-ji-zhu-xue-yuan.md
      - 沙洲职业工学院: universities/sha-zhou-zhi-ye-gong-xue-yuan.md
      - 河海大学: universities/he-hai-da-xue.md
      - 河海大学常州校区: universities/he-hai-da-xue-chang-zhou-xiao-qu.md
      - 泰州学院: universities/tai-zhou-xue-yuan.md
      - 泰州职业技术学院: universities/tai-zhou-zhi-ye-ji-zhu-xue-yuan.md
      - 淮阴工学院: universities/huai-yin-gong-xue-yuan.md
      - 淮阴师范学院: universities/huai-yin-shi-fan-xue-yuan.md
      - 淮阴师范学院交通路校区: universities/huai-yin-shi-fan-xue-yuan-jiao-tong-lu-xiao-qu.md
      - 淮阴师范学院长江路校区: universities/huai-yin-shi-fan-xue-yuan-chang-jiang-lu-xiao-qu.md
      - 盐城工业职业技术学院: universities/yan-cheng-gong-ye-zhi-ye-ji-zhu-xue-yuan.md
      - 盐城工学院: universities/yan-cheng-gong-xue-yuan.md
      - 盐城师范学院: universities/yan-cheng-shi-fan-xue-yuan.md
      - 盐城师范学院通榆校区: universities/yan-cheng-shi-fan-xue-yuan-tong-yu-xiao-qu.md
      - 苏州信息职业技术学院: universities/su-zhou-xin-xi-zhi-ye-ji-zhu-xue-yuan.md
      - 苏州健雄职业技术学院: universities/su-zhou-jian-xiong-zhi-ye-ji-zhu-xue-yuan.md
      - 苏州农业职业技术学院: universities/su-zhou-nong-ye-zhi-ye-ji-zhu-xue-yuan.md
      - 苏州城市学院: universities/su-zhou-cheng-shi-xue-yuan.md
      - 苏州大学: universities/su-zhou-da-xue.md
      - 苏州大学天赐庄校区 东区: universities/su-zhou-da-xue-tian-si-zhuang-xiao-qu-dong-qu.md
      - 苏州大学应用技术学院: universities/su-zhou-da-xue-ying-yong-ji-zhu-xue-yuan.md
      - 苏州大学未来校区: universities/su-zhou-da-xue-wei-lai-xiao-qu.md
      - 苏州大学独墅湖校区: universities/su-zhou-da-xue-du-shu-hu-xiao-qu.md
      - 苏州大学独墅湖校区北区: universities/su-zhou-da-xue-du-shu-hu-xiao-qu-bei-qu.md
      - 苏州大学阳澄湖校区: universities/su-zhou-da-xue-yang-cheng-hu-xiao-qu.md
      - 苏州工业园区服务外包职业学院: universities/su-zhou-gong-ye-yuan-qu-fu-wu-wai-bao-zhi-ye-xue-yuan.md
      - 苏州工业园区职业技术学院: universities/su-zhou-gong-ye-yuan-qu-zhi-ye-ji-zhu-xue-yuan.md
      - 苏州工业职业技术学院: universities/su-zhou-gong-ye-zhi-ye-ji-zhu-xue-yuan.md
      - 苏州工艺美术职业技术学院: universities/su-zhou-gong-yi-mei-shu-zhi-ye-ji-zhu-xue-yuan.md
      - 苏州科技大学: universities/su-zhou-ke-ji-da-xue.md
      - 苏州科技大学天平学院: universities/su-zhou-ke-ji-da-xue-tian-ping-xue-yuan.md
      - 苏州科技大学天平校区: universities/su-zhou-ke-ji-da-xue-tian-ping-xiao-qu.md
      - 苏州科技大学石湖校区: universities/su-zhou-ke-ji-da-xue-shi-hu-xiao-qu.md
      - 苏州经贸职业技术学院: universities/su-zhou-jing-mao-zhi-ye-ji-zhu-xue-yuan.md
      - 西交利物浦大学: universities/xi-jiao-li-wu-pu-da-xue.md
      - 西交利物浦大学太仓校区: universities/xi-jiao-li-wu-pu-da-xue-tai-cang-xiao-qu.md
      - 连云港师范高等专科学校: universities/lian-yun-gang-shi-fan-gao-deng-zhuan-ke-xue-xiao.md
      - 金肯职业技术学院: universities/jin-ken-zhi-ye-ji-zhu-xue-yuan.md
      - 金陵科技学院: universities/jin-ling-ke-ji-xue-yuan.md
      - 钟山职业技术学院: universities/zhong-shan-zhi-ye-ji-zhu-xue-yuan.md
      - 镇江市高等专科学校: universities/zhen-jiang-shi-gao-deng-zhuan-ke-xue-xiao.md
    - 浙江:
      - 上海财经大学浙江学院: universities/shang-hai-cai-jing-da-xue-zhe-jiang-xue-yuan.md
      - 中国美术学院: universities/zhong-guo-mei-shu-xue-yuan.md
      - 中国计量大学: universities/zhong-guo-ji-liang-da-xue.md
      - 中国计量大学现代科技学院: universities/zhong-guo-ji-liang-da-xue-xian-dai-ke-ji-xue-yuan.md
      - 丽水学院: universities/li-shui-xue-yuan.md
      - 丽水职业技术学院: universities/li-shui-zhi-ye-ji-zhu-xue-yuan.md
      - 台州学院: universities/tai-zhou-xue-yuan-2.md
      - 台州科技职业学院: universities/tai-zhou-ke-ji-zhi-ye-xue-yuan.md
      - 台州职业技术学院: universities/tai-zhou-zhi-ye-ji-zhu-xue-yuan-2.md
      - 嘉兴南洋职业技术学院: universities/jia-xing-nan-yang-zhi-ye-ji-zhu-xue-yuan.md
      - 嘉兴南湖学院: universities/jia-xing-nan-hu-xue-yuan.md
      - 嘉兴学院: universities/jia-xing-xue-yuan.md
      - 宁波卫生职业技术学院: universities/zhu-bo-wei-sheng-zhi-ye-ji-zhu-xue-yuan.md
      - 宁波城市职业技术学院: universities/zhu-bo-cheng-shi-zhi-ye-ji-zhu-xue-yuan.md
      - 宁波大学: universities/zhu-bo-da-xue.md
      - 宁波大学科学技术学院: universities/zhu-bo-da-xue-ke-xue-ji-zhu-xue-yuan.md
      - 宁波工程学院: universities/zhu-bo-gong-cheng-xue-yuan.md
      - 宁波幼儿师范高等专科学校: universities/zhu-bo-you-er-shi-fan-gao-deng-zhuan-ke-xue-xiao.md
      - 宁波职业技术学院: universities/zhu-bo-zhi-ye-ji-zhu-xue-yuan.md
      - 宁波诺丁汉大学: universities/zhu-bo-nuo-ding-yi-da-xue.md
      - 宁波诺丁汉大学 university of Nottingham Ningbo China: universities/zhu-bo-nuo-ding-yi-da-xue-university-of-nottingham-ningbo-china.md
      - 宁波财经学院: universities/zhu-bo-cai-jing-xue-yuan.md
      - 杭州万向职业技术学院: universities/hang-zhou-mo-xiang-zhi-ye-ji-zhu-xue-yuan.md
      - 杭州医学院: universities/hang-zhou-yi-xue-yuan.md
      - 杭州医学院临安校区: universities/hang-zhou-yi-xue-yuan-lin-an-xiao-qu.md
      - 杭州师范大学: universities/hang-zhou-shi-fan-da-xue.md
      - 杭州电子科技大学: universities/hang-zhou-dian-zi-ke-ji-da-xue.md
      - 杭州科技职业技术学院: universities/hang-zhou-ke-ji-zhi-ye-ji-zhu-xue-yuan.md
      - 杭州职业技术学院: universities/hang-zhou-zhi-ye-ji-zhu-xue-yuan.md
      - 浙大城市学院: universities/zhe-da-cheng-shi-xue-yuan.md
      - 浙大宁波理工学院: universities/zhe-da-zhu-bo-li-gong-xue-yuan.md
      - 浙江万里学院: universities/zhe-jiang-mo-li-xue-yuan.md
      - 浙江东方职业技术学院: universities/zhe-jiang-dong-fang-zhi-ye-ji-zhu-xue-yuan.md
      - 浙江中医药大学: universities/zhe-jiang-zhong-yi-yao-da-xue.md
      - 浙江交通职业技术学院: universities/zhe-jiang-jiao-tong-zhi-ye-ji-zhu-xue-yuan.md
      - 浙江传媒学院: universities/zhe-jiang-chuan-mei-xue-yuan.md
      - 浙江农林大学: universities/zhe-jiang-nong-lin-da-xue.md
      - 浙江农林大学暨阳学院: universities/zhe-jiang-nong-lin-da-xue-ji-yang-xue-yuan.md
      - 浙江同济科技职业学院: universities/zhe-jiang-tong-ji-ke-ji-zhi-ye-xue-yuan.md
      - 浙江商业职业技术学院: universities/zhe-jiang-shang-ye-zhi-ye-ji-zhu-xue-yuan.md
      - 浙江外国语学院: universities/zhe-jiang-wai-guo-yu-xue-yuan.md
      - 浙江大学: universities/zhe-jiang-da-xue.md
      - 浙江大学宁波理工学院: universities/zhe-jiang-da-xue-zhu-bo-li-gong-xue-yuan.md
      - 浙江大学海宁国际校区: universities/zhe-jiang-da-xue-hai-zhu-guo-ji-xiao-qu.md
      - 浙江宇翔职业技术学院: universities/zhe-jiang-yu-xiang-zhi-ye-ji-zhu-xue-yuan.md
      - 浙江安防职业技术学院: universities/zhe-jiang-an-fang-zhi-ye-ji-zhu-xue-yuan.md
      - 浙江工业大学: universities/zhe-jiang-gong-ye-da-xue.md
      - 浙江工业大学之江学院: universities/zhe-jiang-gong-ye-da-xue-zhi-jiang-xue-yuan.md
      - 浙江工业职业技术学院: universities/zhe-jiang-gong-ye-zhi-ye-ji-zhu-xue-yuan.md
      - 浙江工商大学: universities/zhe-jiang-gong-shang-da-xue.md
      - 浙江工商大学杭州商学院: universities/zhe-jiang-gong-shang-da-xue-hang-zhou-shang-xue-yuan.md
      - 浙江工商大学杭州商学院桐庐校区: universities/zhe-jiang-gong-shang-da-xue-hang-zhou-shang-xue-yuan-tong-lu-xiao-qu.md
      - 浙江工商职业技术学院: universities/zhe-jiang-gong-shang-zhi-ye-ji-zhu-xue-yuan.md
      - 浙江工贸职业技术学院: universities/zhe-jiang-gong-mao-zhi-ye-ji-zhu-xue-yuan.md
      - 浙江师范大学: universities/zhe-jiang-shi-fan-da-xue.md
      - 浙江师范大学萧山校区: universities/zhe-jiang-shi-fan-da-xue-xiao-shan-xiao-qu.md
      - 浙江师范大学行知学院: universities/zhe-jiang-shi-fan-da-xue-xing-zhi-xue-yuan.md
      - 浙江广厦建设职业技术大学: universities/zhe-jiang-yan-sha-jian-she-zhi-ye-ji-zhu-da-xue.md
      - 浙江建设职业技术学院: universities/zhe-jiang-jian-she-zhi-ye-ji-zhu-xue-yuan.md
      - 浙江机电职业技术学院: universities/zhe-jiang-ji-dian-zhi-ye-ji-zhu-xue-yuan.md
      - 浙江树人学院: universities/zhe-jiang-shu-ren-xue-yuan.md
      - 浙江横店影视职业学院: universities/zhe-jiang-heng-dian-ying-shi-zhi-ye-xue-yuan.md
      - 浙江水利水电学院: universities/zhe-jiang-shui-li-shui-dian-xue-yuan.md
      - 浙江水利水电学院南浔校区: universities/zhe-jiang-shui-li-shui-dian-xue-yuan-nan-xun-xiao-qu.md
      - 浙江海洋大学: universities/zhe-jiang-hai-yang-da-xue.md
      - 浙江理工大学: universities/zhe-jiang-li-gong-da-xue.md
      - 浙江理工大学科技与艺术学院: universities/zhe-jiang-li-gong-da-xue-ke-ji-yu-yi-zhu-xue-yuan.md
      - 浙江科技学院: universities/zhe-jiang-ke-ji-xue-yuan.md
      - 浙江科技学院安吉校区: universities/zhe-jiang-ke-ji-xue-yuan-an-ji-xiao-qu.md
      - 浙江纺织服装职业技术学院: universities/zhe-jiang-fang-zhi-fu-zhuang-zhi-ye-ji-zhu-xue-yuan.md
      - 浙江经济职业技术学院: universities/zhe-jiang-jing-ji-zhi-ye-ji-zhu-xue-yuan.md
      - 浙江经贸职业技术学院: universities/zhe-jiang-jing-mao-zhi-ye-ji-zhu-xue-yuan.md
      - 浙江艺术职业学院: universities/zhe-jiang-yi-zhu-zhi-ye-xue-yuan.md
      - 浙江警官职业学院: universities/zhe-jiang-jing-guan-zhi-ye-xue-yuan.md
      - 浙江财经大学: universities/zhe-jiang-cai-jing-da-xue.md
      - 浙江财经大学东方学院: universities/zhe-jiang-cai-jing-da-xue-dong-fang-xue-yuan.md
      - 浙江越秀外国语学院: universities/zhe-jiang-yue-xiu-wai-guo-yu-xue-yuan.md
      - 浙江越秀外国语学院稽山校区: universities/zhe-jiang-yue-xiu-wai-guo-yu-xue-yuan-ji-shan-xiao-qu.md
      - 浙江越秀外国语学院镜湖校区: universities/zhe-jiang-yue-xiu-wai-guo-yu-xue-yuan-jing-hu-xiao-qu.md
      - 浙江邮电职业技术学院: universities/zhe-jiang-you-dian-zhi-ye-ji-zhu-xue-yuan.md
      - 浙江邮电职业技术学院滨海校区: universities/zhe-jiang-you-dian-zhi-ye-ji-zhu-xue-yuan-bin-hai-xiao-qu.md
      - 浙江金融职业学院: universities/zhe-jiang-jin-rong-zhi-ye-xue-yuan.md
      - 浙江长征职业技术学院: universities/zhe-jiang-chang-zheng-zhi-ye-ji-zhu-xue-yuan.md
      - 浙江音乐学院: universities/zhe-jiang-yin-le-xue-yuan.md
      - 温州医科大学: universities/wen-zhou-yi-ke-da-xue.md
      - 温州医科大学茶山校区: universities/wen-zhou-yi-ke-da-xue-cha-shan-xiao-qu.md
      - 温州大学: universities/wen-zhou-da-xue.md
      - 温州大学学院路校区继续教育学院: universities/wen-zhou-da-xue-xue-yuan-lu-xiao-qu-ji-xu-jiao-yu-xue-yuan.md
      - 温州大学瓯江学院: universities/wen-zhou-da-xue-ou-jiang-xue-yuan.md
      - 温州理工学院: universities/wen-zhou-li-gong-xue-yuan.md
      - 温州科技职业学院: universities/wen-zhou-ke-ji-zhi-ye-xue-yuan.md
      - 温州职业技术学院茶山校区: universities/wen-zhou-zhi-ye-ji-zhu-xue-yuan-cha-shan-xiao-qu.md
      - 温州肯恩大学: universities/wen-zhou-ken-en-da-xue.md
      - 湖州学院: universities/hu-zhou-xue-yuan.md
      - 湖州师范学院: universities/hu-zhou-shi-fan-xue-yuan.md
      - 湖州职业技术学院: universities/hu-zhou-zhi-ye-ji-zhu-xue-yuan.md
      - 绍兴文理学院: universities/shao-xing-wen-li-xue-yuan.md
      - 绍兴文理学院元培学院: universities/shao-xing-wen-li-xue-yuan-yuan-pei-xue-yuan.md
      - 绍兴职业技术学院: universities/shao-xing-zhi-ye-ji-zhu-xue-yuan.md
      - 衢州学院: universities/qu-zhou-xue-yuan.md
      - 衢州职业技术学院: universities/qu-zhou-zhi-ye-ji-zhu-xue-yuan.md
      - 金华职业技术学院: universities/jin-hua-zhi-ye-ji-zhu-xue-yuan.md
    - 安徽:
      - 中国科学技术大学: universities/zhong-guo-ke-xue-ji-zhu-da-xue.md
      - 亳州学院: universities/bo-zhou-xue-yuan.md
      - 六安职业技术学院: universities/liu-an-zhi-ye-ji-zhu-xue-yuan.md
      - 合肥信息技术职业学院: universities/he-fei-xin-xi-ji-zhu-zhi-ye-xue-yuan.md
      - 合肥城市学院: universities/he-fei-cheng-shi-xue-yuan.md
      - 合肥学院: universities/he-fei-xue-yuan.md
      - 合肥工业大学: universities/he-fei-gong-ye-da-xue.md
      - 合肥工业大学宣城校区: universities/he-fei-gong-ye-da-xue-xuan-cheng-xiao-qu.md
      - 合肥工业大学屯溪路校区: universities/he-fei-gong-ye-da-xue-tun-xi-lu-xiao-qu.md
      - 合肥工业大学翡翠湖小区: universities/he-fei-gong-ye-da-xue-fei-cui-hu-xiao-qu-2.md
      - 合肥工业大学翡翠湖校区: universities/he-fei-gong-ye-da-xue-fei-cui-hu-xiao-qu.md
      - 合肥师范学院: universities/he-fei-shi-fan-xue-yuan.md
      - 合肥经济学院: universities/he-fei-jing-ji-xue-yuan.md
      - 合肥职业技术学院: universities/he-fei-zhi-ye-ji-zhu-xue-yuan.md
      - 安庆师范大学: universities/an-qing-shi-fan-da-xue.md
      - 安庆职业技术学院: universities/an-qing-zhi-ye-ji-zhu-xue-yuan.md
      - 安徽三联学院: universities/an-hui-san-lian-xue-yuan.md
      - 安徽中医药大学: universities/an-hui-zhong-yi-yao-da-xue.md
      - 安徽中医药大学少荃湖校区: universities/an-hui-zhong-yi-yao-da-xue-shao-quan-hu-xiao-qu.md
      - 安徽中医药大学梅山路校区: universities/an-hui-zhong-yi-yao-da-xue-mei-shan-lu-xiao-qu.md
      - 安徽中医药高等专科学校: universities/an-hui-zhong-yi-yao-gao-deng-zhuan-ke-xue-xiao.md
      - 安徽交通职业技术学院: universities/an-hui-jiao-tong-zhi-ye-ji-zhu-xue-yuan.md
      - 安徽信息工程学院: universities/an-hui-xin-xi-gong-cheng-xue-yuan.md
      - 安徽公安职业学院: universities/an-hui-gong-an-zhi-ye-xue-yuan.md
      - 安徽农业大学: universities/an-hui-nong-ye-da-xue.md
      - 安徽医科大学: universities/an-hui-yi-ke-da-xue.md
      - 安徽医科大学临床医学院: universities/an-hui-yi-ke-da-xue-lin-chuang-yi-xue-yuan.md
      - 安徽医科大学本部: universities/an-hui-yi-ke-da-xue-ben-bu.md
      - 安徽卫生健康职业学院: universities/an-hui-wei-sheng-jian-kang-zhi-ye-xue-yuan.md
      - 安徽商贸职业技术学院: universities/an-hui-shang-mao-zhi-ye-ji-zhu-xue-yuan.md
      - 安徽国际商务职业学院: universities/an-hui-guo-ji-shang-wu-zhi-ye-xue-yuan.md
      - 安徽城市管理职业学院磨店校区: universities/an-hui-cheng-shi-guan-li-zhi-ye-xue-yuan-mo-dian-xiao-qu.md
      - 安徽外国语学院: universities/an-hui-wai-guo-yu-xue-yuan.md
      - 安徽大学: universities/an-hui-da-xue.md
      - 安徽大学磬苑校区: universities/an-hui-da-xue-qing-yuan-xiao-qu.md
      - 安徽大学蜀山校区: universities/an-hui-da-xue-shu-shan-xiao-qu.md
      - 安徽工业大学: universities/an-hui-gong-ye-da-xue.md
      - 安徽工商职业学院: universities/an-hui-gong-shang-zhi-ye-xue-yuan.md
      - 安徽工程大学: universities/an-hui-gong-cheng-da-xue.md
      - 安徽师范大学: universities/an-hui-shi-fan-da-xue.md
      - 安徽师范大学天门山校区: universities/an-hui-shi-fan-da-xue-tian-men-shan-xiao-qu.md
      - 安徽师范大学花津校区: universities/an-hui-shi-fan-da-xue-hua-jin-xiao-qu.md
      - 安徽建筑大学: universities/an-hui-jian-zhu-da-xue.md
      - 安徽建筑大学北校区: universities/an-hui-jian-zhu-da-xue-bei-xiao-qu.md
      - 安徽文达信息工程学院: universities/an-hui-wen-da-xin-xi-gong-cheng-xue-yuan.md
      - 安徽新华学院: universities/an-hui-xin-hua-xue-yuan.md
      - 安徽林业职业技术学院: universities/an-hui-lin-ye-zhi-ye-ji-zhu-xue-yuan.md
      - 安徽水利水电职业技术学院: universities/an-hui-shui-li-shui-dian-zhi-ye-ji-zhu-xue-yuan.md
      - 安徽现代信息工程职业学院: universities/an-hui-xian-dai-xin-xi-gong-cheng-zhi-ye-xue-yuan.md
      - 安徽理工大学: universities/an-hui-li-gong-da-xue.md
      - 安徽理工大学山南校区: universities/an-hui-li-gong-da-xue-shan-nan-xiao-qu.md
      - 安徽科技学院: universities/an-hui-ke-ji-xue-yuan.md
      - 安徽粮食工程职业学院: universities/an-hui-liang-shi-gong-cheng-zhi-ye-xue-yuan.md
      - 安徽职业技术学院: universities/an-hui-zhi-ye-ji-zhu-xue-yuan.md
      - 安徽艺术学院: universities/an-hui-yi-zhu-xue-yuan.md
      - 安徽艺术职业学院丹霞校区: universities/an-hui-yi-zhu-zhi-ye-xue-yuan-dan-xia-xiao-qu.md
      - 安徽财经大学: universities/an-hui-cai-jing-da-xue.md
      - 安徽财贸职业学院: universities/an-hui-cai-mao-zhi-ye-xue-yuan.md
      - 安徽邮电职业技术学院: universities/an-hui-you-dian-zhi-ye-ji-zhu-xue-yuan.md
      - 宿州学院: universities/su-zhou-xue-yuan.md
      - 宿州职业技术学院: universities/su-zhou-zhi-ye-ji-zhu-xue-yuan.md
      - 巢湖学院: universities/chao-hu-xue-yuan.md
      - 桐城师范高等专科学校: universities/tong-cheng-shi-fan-gao-deng-zhuan-ke-xue-xiao.md
      - 池州学院: universities/chi-zhou-xue-yuan.md
      - 淮北师范大学: universities/huai-bei-shi-fan-da-xue.md
      - 淮南师范学院: universities/huai-nan-shi-fan-xue-yuan.md
      - 淮南联合大学: universities/huai-nan-lian-he-da-xue.md
      - 滁州学院: universities/chu-zhou-xue-yuan.md
      - 皖南医学院: universities/wan-nan-yi-xue-yuan.md
      - 皖江工学院: universities/wan-jiang-gong-xue-yuan.md
      - 皖西卫生职业学院: universities/wan-xi-wei-sheng-zhi-ye-xue-yuan.md
      - 皖西学院: universities/wan-xi-xue-yuan.md
      - 芜湖职业技术学院: universities/wu-hu-zhi-ye-ji-zhu-xue-yuan.md
      - 铜陵学院: universities/tong-ling-xue-yuan.md
      - 阜阳师范大学: universities/fu-yang-shi-fan-da-xue.md
      - 阜阳师范大学三里桥校区: universities/fu-yang-shi-fan-da-xue-san-li-qiao-xiao-qu.md
      - 阜阳职业技术学院: universities/fu-yang-zhi-ye-ji-zhu-xue-yuan.md
      - 马鞍山学院: universities/ma-an-shan-xue-yuan.md
      - 黄山学院: universities/huang-shan-xue-yuan.md
    - 福建:
      - 三明医学科技职业学院: universities/san-ming-yi-xue-ke-ji-zhi-ye-xue-yuan.md
      - 三明学院: universities/san-ming-xue-yuan.md
      - 仰恩大学: universities/yang-en-da-xue.md
      - 华侨大学: universities/hua-qiao-da-xue.md
      - 华侨大学厦门校区: universities/hua-qiao-da-xue-sha-men-xiao-qu.md
      - 厦门医学院: universities/sha-men-yi-xue-yuan.md
      - 厦门华厦学院: universities/sha-men-hua-sha-xue-yuan.md
      - 厦门城市职业学院: universities/sha-men-cheng-shi-zhi-ye-xue-yuan.md
      - 厦门大学: universities/sha-men-da-xue.md
      - 厦门大学创意与创新学院: universities/sha-men-da-xue-chuang-yi-yu-chuang-xin-xue-yuan.md
      - 厦门大学嘉庚学院: universities/sha-men-da-xue-jia-geng-xue-yuan.md
      - 厦门大学思明校区: universities/sha-men-da-xue-si-ming-xiao-qu.md
      - 厦门大学翔安校区: universities/sha-men-da-xue-xiang-an-xiao-qu.md
      - 厦门大学马来西亚分校: universities/sha-men-da-xue-ma-lai-xi-ya-fen-xiao.md
      - 厦门工学院: universities/sha-men-gong-xue-yuan.md
      - 厦门演艺职业学院: universities/sha-men-yan-yi-zhi-ye-xue-yuan.md
      - 厦门理工学院: universities/sha-men-li-gong-xue-yuan.md
      - 厦门软件职业技术学院: universities/sha-men-ruan-jian-zhi-ye-ji-zhu-xue-yuan.md
      - 宁德师范学院: universities/zhu-de-shi-fan-xue-yuan.md
      - 武夷学院: universities/wu-yi-xue-yuan.md
      - 武夷山职业学院: universities/wu-yi-shan-zhi-ye-xue-yuan.md
      - 泉州信息工程学院: universities/quan-zhou-xin-xi-gong-cheng-xue-yuan.md
      - 泉州医学高等专科学校: universities/quan-zhou-yi-xue-gao-deng-zhuan-ke-xue-xiao.md
      - 泉州华光职业学院: universities/quan-zhou-hua-guang-zhi-ye-xue-yuan.md
      - 泉州师范学院: universities/quan-zhou-shi-fan-xue-yuan.md
      - 泉州海洋职业学院: universities/quan-zhou-hai-yang-zhi-ye-xue-yuan.md
      - 泉州职业技术大学: universities/quan-zhou-zhi-ye-ji-zhu-da-xue.md
      - 泉州轻工职业学院: universities/quan-zhou-qing-gong-zhi-ye-xue-yuan.md
      - 漳州卫生职业学院: universities/zhang-zhou-wei-sheng-zhi-ye-xue-yuan.md
      - 漳州理工职业学院旧校区，龙文校区: universities/zhang-zhou-li-gong-zhi-ye-xue-yuan-jiu-xiao-qu-long-wen-xiao-qu.md
      - 漳州科技职业学院: universities/zhang-zhou-ke-ji-zhi-ye-xue-yuan.md
      - 福州外语外贸学院: universities/fu-zhou-wai-yu-wai-mao-xue-yuan.md
      - 福州大学: universities/fu-zhou-da-xue.md
      - 福州大学厦门工艺美术学院: universities/fu-zhou-da-xue-sha-men-gong-yi-mei-shu-xue-yuan.md
      - 福州大学晋江校区: universities/fu-zhou-da-xue-jin-jiang-xiao-qu.md
      - 福州大学铜盘校区: universities/fu-zhou-da-xue-tong-pan-xiao-qu.md
      - 福州工商学院: universities/fu-zhou-gong-shang-xue-yuan.md
      - 福州理工学院: universities/fu-zhou-li-gong-xue-yuan.md
      - 福州职业技术学院: universities/fu-zhou-zhi-ye-ji-zhu-xue-yuan.md
      - 福州英华职业学院: universities/fu-zhou-ying-hua-zhi-ye-xue-yuan.md
      - 福建中医药大学: universities/fu-jian-zhong-yi-yao-da-xue.md
      - 福建农业职业技术学院: universities/fu-jian-nong-ye-zhi-ye-ji-zhu-xue-yuan.md
      - 福建农林大学: universities/fu-jian-nong-lin-da-xue.md
      - 福建农林大学安溪校区: universities/fu-jian-nong-lin-da-xue-an-xi-xiao-qu.md
      - 福建农林大学旗山校区: universities/fu-jian-nong-lin-da-xue-qi-shan-xiao-qu.md
      - 福建医科大学: universities/fu-jian-yi-ke-da-xue.md
      - 福建华南女子职业学院: universities/fu-jian-hua-nan-nu-zi-zhi-ye-xue-yuan.md
      - 福建卫生职业技术学院: universities/fu-jian-wei-sheng-zhi-ye-ji-zhu-xue-yuan.md
      - 福建商学院: universities/fu-jian-shang-xue-yuan.md
      - 福建工程学院: universities/fu-jian-gong-cheng-xue-yuan.md
      - 福建师范大学: universities/fu-jian-shi-fan-da-xue.md
      - 福建师范大学协和学院: universities/fu-jian-shi-fan-da-xue-xie-he-xue-yuan.md
      - 福建幼儿师范高等专科学校: universities/fu-jian-you-er-shi-fan-gao-deng-zhuan-ke-xue-xiao.md
      - 福建技术师范学院: universities/fu-jian-ji-zhu-shi-fan-xue-yuan.md
      - 福建林业职业技术学院: universities/fu-jian-lin-ye-zhi-ye-ji-zhu-xue-yuan.md
      - 福建水利电力职业技术学院: universities/fu-jian-shui-li-dian-li-zhi-ye-ji-zhu-xue-yuan.md
      - 福建江夏学院: universities/fu-jian-jiang-xia-xue-yuan.md
      - 福建生物工程职业技术学院: universities/fu-jian-sheng-wu-gong-cheng-zhi-ye-ji-zhu-xue-yuan.md
      - 福建艺术职业学院: universities/fu-jian-yi-zhu-zhi-ye-xue-yuan.md
      - 莆田学院: universities/fu-tian-xue-yuan.md
      - 闽南师范大学: universities/min-nan-shi-fan-da-xue.md
      - 闽南科技学院: universities/min-nan-ke-ji-xue-yuan.md
      - 闽南科技学院康美校区: universities/min-nan-ke-ji-xue-yuan-kang-mei-xiao-qu.md
      - 闽江学院: universities/min-jiang-xue-yuan.md
      - 闽西职业技术学院: universities/min-xi-zhi-ye-ji-zhu-xue-yuan.md
      - 阳光学院: universities/yang-guang-xue-yuan.md
      - 集美大学: universities/ji-mei-da-xue.md
      - 集美大学诚毅学院: universities/ji-mei-da-xue-cheng-yi-xue-yuan.md
      - 黎明职业大学: universities/li-ming-zhi-ye-da-xue.md
      - 龙岩学院: universities/long-yan-xue-yuan.md
    - 江西:
      - 上饶师范学院: universities/shang-rao-shi-fan-xue-yuan.md
      - 东华理工大学: universities/dong-hua-li-gong-da-xue.md
      - 东华理工大学抚州校区: universities/dong-hua-li-gong-da-xue-fu-zhou-xiao-qu.md
      - 九江学院: universities/jiu-jiang-xue-yuan.md
      - 九江职业大学: universities/jiu-jiang-zhi-ye-da-xue.md
      - 九江职业技术学院: universities/jiu-jiang-zhi-ye-ji-zhu-xue-yuan.md
      - 九江职业技术学院现更名为江西职业技术大学: universities/jiu-jiang-zhi-ye-ji-zhu-xue-yuan-xian-geng-ming-wei-jiang-xi-zhi-ye-ji-zhu-da-xue.md
      - 井冈山大学: universities/jing-gang-shan-da-xue.md
      - 华东交通大学: universities/hua-dong-jiao-tong-da-xue.md
      - 华东交通大学军山湖校区: universities/hua-dong-jiao-tong-da-xue-jun-shan-hu-xiao-qu.md
      - 南昌交通学院: universities/nan-chang-jiao-tong-xue-yuan.md
      - 南昌交通学院，以下回答默认墨轩湖校区: universities/nan-chang-jiao-tong-xue-yuan-yi-xia-hui-da-mo-ren-mo-xuan-hu-xiao-qu.md
      - 南昌医学院: universities/nan-chang-yi-xue-yuan.md
      - 南昌大学: universities/nan-chang-da-xue.md
      - 南昌大学医学院: universities/nan-chang-da-xue-yi-xue-yuan.md
      - 南昌大学抚州医学院: universities/nan-chang-da-xue-fu-zhou-yi-xue-yuan.md
      - 南昌大学科学技术学院: universities/nan-chang-da-xue-ke-xue-ji-zhu-xue-yuan.md
      - 南昌工学院: universities/nan-chang-gong-xue-yuan.md
      - 南昌工程学院: universities/nan-chang-gong-cheng-xue-yuan.md
      - 南昌工程学院瑶湖校区: universities/nan-chang-gong-cheng-xue-yuan-yao-hu-xiao-qu.md
      - 南昌师范学院: universities/nan-chang-shi-fan-xue-yuan.md
      - 南昌应用技术师范学院: universities/nan-chang-ying-yong-ji-zhu-shi-fan-xue-yuan.md
      - 南昌理工学院: universities/nan-chang-li-gong-xue-yuan.md
      - 南昌职业大学: universities/nan-chang-zhi-ye-da-xue.md
      - 南昌航空大学: universities/nan-chang-hang-kong-da-xue.md
      - 南昌航空大学科技学院: universities/nan-chang-hang-kong-da-xue-ke-ji-xue-yuan.md
      - 宜春学院: universities/yi-chun-xue-yuan.md
      - 宜春幼儿师范高等专科学校: universities/yi-chun-you-er-shi-fan-gao-deng-zhuan-ke-xue-xiao.md
      - 抚州医学院南昌大学抚州医学院: universities/fu-zhou-yi-xue-yuan-nan-chang-da-xue-fu-zhou-yi-xue-yuan.md
      - 新余学院: universities/xin-yu-xue-yuan.md
      - 景德镇学院: universities/jing-de-zhen-xue-yuan.md
      - 景德镇艺术职业大学: universities/jing-de-zhen-yi-zhu-zhi-ye-da-xue.md
      - 景德镇陶瓷大学: universities/jing-de-zhen-tao-ci-da-xue.md
      - 景德镇陶瓷职业技术学院: universities/jing-de-zhen-tao-ci-zhi-ye-ji-zhu-xue-yuan.md
      - 江西中医药大学: universities/jiang-xi-zhong-yi-yao-da-xue.md
      - 江西交通职业技术学院: universities/jiang-xi-jiao-tong-zhi-ye-ji-zhu-xue-yuan.md
      - 江西传媒职业学院: universities/jiang-xi-chuan-mei-zhi-ye-xue-yuan.md
      - 江西信息应用职业技术学院: universities/jiang-xi-xin-xi-ying-yong-zhi-ye-ji-zhu-xue-yuan.md
      - 江西农业大学: universities/jiang-xi-nong-ye-da-xue.md
      - 江西农业大学南昌商学院: universities/jiang-xi-nong-ye-da-xue-nan-chang-shang-xue-yuan.md
      - 江西农业工程职业学院: universities/jiang-xi-nong-ye-gong-cheng-zhi-ye-xue-yuan.md
      - 江西冶金职业技术学院: universities/jiang-xi-ye-jin-zhi-ye-ji-zhu-xue-yuan.md
      - 江西制造职业技术学院: universities/jiang-xi-zhi-zao-zhi-ye-ji-zhu-xue-yuan.md
      - 江西医学高等专科学校: universities/jiang-xi-yi-xue-gao-deng-zhuan-ke-xue-xiao.md
      - 江西外语外贸职业学院: universities/jiang-xi-wai-yu-wai-mao-zhi-ye-xue-yuan.md
      - 江西工业工程职业技术学院: universities/jiang-xi-gong-ye-gong-cheng-zhi-ye-ji-zhu-xue-yuan.md
      - 江西工业职业技术学院: universities/jiang-xi-gong-ye-zhi-ye-ji-zhu-xue-yuan.md
      - 江西工业贸易职业技术学院: universities/jiang-xi-gong-ye-mao-yi-zhi-ye-ji-zhu-xue-yuan.md
      - 江西工程学院: universities/jiang-xi-gong-cheng-xue-yuan.md
      - 江西师范大学: universities/jiang-xi-shi-fan-da-xue.md
      - 江西师范大学科学技术学院: universities/jiang-xi-shi-fan-da-xue-ke-xue-ji-zhu-xue-yuan.md
      - 江西师范高等专科学校: universities/jiang-xi-shi-fan-gao-deng-zhuan-ke-xue-xiao.md
      - 江西应用工程职业学院: universities/jiang-xi-ying-yong-gong-cheng-zhi-ye-xue-yuan.md
      - 江西应用技术职业学院: universities/jiang-xi-ying-yong-ji-zhu-zhi-ye-xue-yuan.md
      - 江西应用科技学院: universities/jiang-xi-ying-yong-ke-ji-xue-yuan.md
      - 江西建设职业技术学院: universities/jiang-xi-jian-she-zhi-ye-ji-zhu-xue-yuan.md
      - 江西旅游商贸职业学院: universities/jiang-xi-lu-you-shang-mao-zhi-ye-xue-yuan.md
      - 江西服装学院: universities/jiang-xi-fu-zhuang-xue-yuan.md
      - 江西机电职业技术学院: universities/jiang-xi-ji-dian-zhi-ye-ji-zhu-xue-yuan.md
      - 江西泰豪动漫职业学院: universities/jiang-xi-tai-hao-dong-man-zhi-ye-xue-yuan.md
      - 江西洪州职业学院: universities/jiang-xi-hong-zhou-zhi-ye-xue-yuan.md
      - 江西环境工程职业学院: universities/jiang-xi-huan-jing-gong-cheng-zhi-ye-xue-yuan.md
      - 江西现代职业技术学院: universities/jiang-xi-xian-dai-zhi-ye-ji-zhu-xue-yuan.md
      - 江西理工大学: universities/jiang-xi-li-gong-da-xue.md
      - 江西电力职业技术学院: universities/jiang-xi-dian-li-zhi-ye-ji-zhu-xue-yuan.md
      - 江西科技学院: universities/jiang-xi-ke-ji-xue-yuan.md
      - 江西科技师范大学: universities/jiang-xi-ke-ji-shi-fan-da-xue.md
      - 江西科技师范大学枫林校区: universities/jiang-xi-ke-ji-shi-fan-da-xue-feng-lin-xiao-qu.md
      - 江西科技师范大学红角洲校区: universities/jiang-xi-ke-ji-shi-fan-da-xue-hong-jiao-zhou-xiao-qu.md
      - 江西财经大学: universities/jiang-xi-cai-jing-da-xue.md
      - 江西财经大学现代经济管理学院: universities/jiang-xi-cai-jing-da-xue-xian-dai-jing-ji-guan-li-xue-yuan.md
      - 江西软件职业技术大学: universities/jiang-xi-ruan-jian-zhi-ye-ji-zhu-da-xue.md
      - 江西陶瓷工艺美术职业技术学院: universities/jiang-xi-tao-ci-gong-yi-mei-shu-zhi-ye-ji-zhu-xue-yuan.md
      - 萍乡卫生职业学院: universities/ping-xiang-wei-sheng-zhi-ye-xue-yuan.md
      - 萍乡学院: universities/ping-xiang-xue-yuan.md
      - 豫章师范学院湾里校区: universities/yu-zhang-shi-fan-xue-yuan-wan-li-xiao-qu.md
      - 赣东学院: universities/gan-dong-xue-yuan.md
      - 赣南医学院: universities/gan-nan-yi-xue-yuan.md
      - 赣南师范大学: universities/gan-nan-shi-fan-da-xue.md
      - 赣南师范大学硕士研究生+中山大学新华学院本科: universities/gan-nan-shi-fan-da-xue-shuo-shi-yan-jiu-sheng-zhong-shan-da-xue-xin-hua-xue-yuan-ben-ke.md
      - 赣南师范大学科技学院: universities/gan-nan-shi-fan-da-xue-ke-ji-xue-yuan.md
      - 赣南科技学院: universities/gan-nan-ke-ji-xue-yuan.md
      - 赣州师范高等专科学校: universities/gan-zhou-shi-fan-gao-deng-zhuan-ke-xue-xiao.md
      - 赣州职业技术学院: universities/gan-zhou-zhi-ye-ji-zhu-xue-yuan.md
    - 山东:
      - 东营科技职业学院: universities/dong-ying-ke-ji-zhi-ye-xue-yuan.md
      - 东营职业学院: universities/dong-ying-zhi-ye-xue-yuan.md
      - 中国海洋大学: universities/zhong-guo-hai-yang-da-xue.md
      - 中国石油大学华东: universities/zhong-guo-shi-you-da-xue-hua-dong.md
      - 临沂大学: universities/lin-yi-da-xue.md
      - 临沂大学校本部: universities/lin-yi-da-xue-xiao-ben-bu.md
      - 临沂大学费县分校: universities/lin-yi-da-xue-fei-xian-fen-xiao.md
      - 临沂科技职业学院: universities/lin-yi-ke-ji-zhi-ye-xue-yuan.md
      - 临沂职业学院: universities/lin-yi-zhi-ye-xue-yuan.md
      - 北京交通大学威海校区: universities/bei-jing-jiao-tong-da-xue-wei-hai-xiao-qu.md
      - 哈尔滨工业大学威海: universities/ha-er-bin-gong-ye-da-xue-wei-hai.md
      - 哈尔滨工业大学威海校区: universities/ha-er-bin-gong-ye-da-xue-wei-hai-xiao-qu.md
      - 山东中医药大学: universities/shan-dong-zhong-yi-yao-da-xue.md
      - 山东中医药大学长清校区: universities/shan-dong-zhong-yi-yao-da-xue-chang-qing-xiao-qu.md
      - 山东中医药高等专科学校: universities/shan-dong-zhong-yi-yao-gao-deng-zhuan-ke-xue-xiao.md
      - 山东交通学院: universities/shan-dong-jiao-tong-xue-yuan.md
      - 山东交通学院威海校区: universities/shan-dong-jiao-tong-xue-yuan-wei-hai-xiao-qu.md
      - 山东交通学院长清校区: universities/shan-dong-jiao-tong-xue-yuan-chang-qing-xiao-qu.md
      - 山东交通职业学院: universities/shan-dong-jiao-tong-zhi-ye-xue-yuan.md
      - 山东传媒职业学院: universities/shan-dong-chuan-mei-zhi-ye-xue-yuan.md
      - 山东体育学院: universities/shan-dong-ti-yu-xue-yuan.md
      - 山东信息职业技术学院滨海校区: universities/shan-dong-xin-xi-zhi-ye-ji-zhu-xue-yuan-bin-hai-xiao-qu.md
      - 山东农业大学: universities/shan-dong-nong-ye-da-xue.md
      - 山东农业大学泮河校区: universities/shan-dong-nong-ye-da-xue-pan-he-xiao-qu.md
      - 山东农业工程学院: universities/shan-dong-nong-ye-gong-cheng-xue-yuan.md
      - 山东农业工程学院淄博校区: universities/shan-dong-nong-ye-gong-cheng-xue-yuan-zi-bo-xiao-qu.md
      - 山东劳动职业技术学院: universities/shan-dong-lao-dong-zhi-ye-ji-zhu-xue-yuan.md
      - 山东华宇工学院: universities/shan-dong-hua-yu-gong-xue-yuan.md
      - 山东协和学院: universities/shan-dong-xie-he-xue-yuan.md
      - 山东司法警官职业学院: universities/shan-dong-si-fa-jing-guan-zhi-ye-xue-yuan.md
      - 山东商业职业技术学院: universities/shan-dong-shang-ye-zhi-ye-ji-zhu-xue-yuan.md
      - 山东商务职业学院: universities/shan-dong-shang-wu-zhi-ye-xue-yuan.md
      - 山东外事职业大学: universities/shan-dong-wai-shi-zhi-ye-da-xue.md
      - 山东外贸职业学院: universities/shan-dong-wai-mao-zhi-ye-xue-yuan.md
      - 山东大学: universities/shan-dong-da-xue.md
      - 山东大学威海校区: universities/shan-dong-da-xue-wei-hai-xiao-qu.md
      - 山东大学软件园校区: universities/shan-dong-da-xue-ruan-jian-yuan-xiao-qu.md
      - 山东大学青岛: universities/shan-dong-da-xue-qing-dao.md
      - 山东大学青岛校区: universities/shan-dong-da-xue-qing-dao-xiao-qu.md
      - 山东女子学院: universities/shan-dong-nu-zi-xue-yuan.md
      - 山东工业职业学院: universities/shan-dong-gong-ye-zhi-ye-xue-yuan.md
      - 山东工商学院: universities/shan-dong-gong-shang-xue-yuan.md
      - 山东工程职业技术大学: universities/shan-dong-gong-cheng-zhi-ye-ji-zhu-da-xue.md
      - 山东工艺美术学院: universities/shan-dong-gong-yi-mei-shu-xue-yuan.md
      - 山东工艺美术学院长清校区: universities/shan-dong-gong-yi-mei-shu-xue-yuan-chang-qing-xiao-qu.md
      - 山东师范大学: universities/shan-dong-shi-fan-da-xue.md
      - 山东师范大学长清湖校区: universities/shan-dong-shi-fan-da-xue-chang-qing-hu-xiao-qu.md
      - 山东建筑大学: universities/shan-dong-jian-zhu-da-xue.md
      - 山东政法学院: universities/shan-dong-zheng-fa-xue-yuan.md
      - 山东旅游职业学院: universities/shan-dong-lu-you-zhi-ye-xue-yuan.md
      - 山东水利职业学院: universities/shan-dong-shui-li-zhi-ye-xue-yuan.md
      - 山东现代学院: universities/shan-dong-xian-dai-xue-yuan.md
      - 山东理工大学: universities/shan-dong-li-gong-da-xue.md
      - 山东理工职业学院: universities/shan-dong-li-gong-zhi-ye-xue-yuan.md
      - 山东畜牧兽医职业学院: universities/shan-dong-chu-mu-shou-yi-zhi-ye-xue-yuan.md
      - 山东石油化工学院: universities/shan-dong-shi-you-hua-gong-xue-yuan.md
      - 山东科技大学: universities/shan-dong-ke-ji-da-xue.md
      - 山东科技大学济南校区: universities/shan-dong-ke-ji-da-xue-ji-nan-xiao-qu.md
      - 山东科技大学青岛校区: universities/shan-dong-ke-ji-da-xue-qing-dao-xiao-qu.md
      - 山东科技职业学院: universities/shan-dong-ke-ji-zhi-ye-xue-yuan.md
      - 山东第一医科大学: universities/shan-dong-di-yi-yi-ke-da-xue.md
      - 山东第一医科大学山东省医学科学院: universities/shan-dong-di-yi-yi-ke-da-xue-shan-dong-sheng-yi-xue-ke-xue-yuan.md
      - 山东第一医科大学济南主校区: universities/shan-dong-di-yi-yi-ke-da-xue-ji-nan-zhu-xiao-qu.md
      - 山东第一医科大学济南校区: universities/shan-dong-di-yi-yi-ke-da-xue-ji-nan-xiao-qu.md
      - 山东管理学院: universities/shan-dong-guan-li-xue-yuan.md
      - 山东职业学院: universities/shan-dong-zhi-ye-xue-yuan.md
      - 山东航空学院原滨州学院: universities/shan-dong-hang-kong-xue-yuan-yuan-bin-zhou-xue-yuan.md
      - 山东艺术学院: universities/shan-dong-yi-zhu-xue-yuan.md
      - 山东英才学院: universities/shan-dong-ying-cai-xue-yuan.md
      - 山东药品食品职业学院: universities/shan-dong-yao-pin-shi-pin-zhi-ye-xue-yuan.md
      - 山东警察学院: universities/shan-dong-jing-cha-xue-yuan.md
      - 山东财经大学: universities/shan-dong-cai-jing-da-xue.md
      - 山东财经大学圣井校区: universities/shan-dong-cai-jing-da-xue-sheng-jing-xiao-qu.md
      - 山东财经大学大学燕山学院: universities/shan-dong-cai-jing-da-xue-da-xue-yan-shan-xue-yuan.md
      - 山东财经大学燕山学院: universities/shan-dong-cai-jing-da-xue-yan-shan-xue-yuan.md
      - 山东轻工职业学院: universities/shan-dong-qing-gong-zhi-ye-xue-yuan.md
      - 山东铝业职业学院威海校区: universities/shan-dong-lu-ye-zhi-ye-xue-yuan-wei-hai-xiao-qu.md
      - 山东青年政治学院: universities/shan-dong-qing-nian-zheng-zhi-xue-yuan.md
      - 日照职业技术学院: universities/ri-zhao-zhi-ye-ji-zhu-xue-yuan.md
      - 曲阜师范大学: universities/qu-fu-shi-fan-da-xue.md
      - 曲阜师范大学日照校区: universities/qu-fu-shi-fan-da-xue-ri-zhao-xiao-qu.md
      - 枣庄学院: universities/zao-zhuang-xue-yuan.md
      - 枣庄学院市中校区: universities/zao-zhuang-xue-yuan-shi-zhong-xiao-qu.md
      - 枣庄科技职业学院: universities/zao-zhuang-ke-ji-zhi-ye-xue-yuan.md
      - 泰山学院: universities/tai-shan-xue-yuan.md
      - 泰山护理职业学院: universities/tai-shan-hu-li-zhi-ye-xue-yuan.md
      - 泰山科技学院: universities/tai-shan-ke-ji-xue-yuan.md
      - 泰山职业技术学院: universities/tai-shan-zhi-ye-ji-zhu-xue-yuan.md
      - 济南大学: universities/ji-nan-da-xue-2.md
      - 济南工程职业技术学院: universities/ji-nan-gong-cheng-zhi-ye-ji-zhu-xue-yuan.md
      - 济南幼儿师范高等专科学校: universities/ji-nan-you-er-shi-fan-gao-deng-zhuan-ke-xue-xiao.md
      - 济南职业学院: universities/ji-nan-zhi-ye-xue-yuan.md
      - 济宁医学院: universities/ji-zhu-yi-xue-yuan.md
      - 济宁医学院日照校区: universities/ji-zhu-yi-xue-yuan-ri-zhao-xiao-qu.md
      - 济宁学院: universities/ji-zhu-xue-yuan.md
      - 济宁职业技术学院: universities/ji-zhu-zhi-ye-ji-zhu-xue-yuan.md
      - 淄博师范高等专科学校: universities/zi-bo-shi-fan-gao-deng-zhuan-ke-xue-xiao.md
      - 淄博职业学院: universities/zi-bo-zhi-ye-xue-yuan.md
      - 滨州医学院: universities/bin-zhou-yi-xue-yuan.md
      - 滨州医学院烟台校区: universities/bin-zhou-yi-xue-yuan-yan-tai-xiao-qu.md
      - 滨州学院: universities/bin-zhou-xue-yuan.md
      - 滨州职业学院: universities/bin-zhou-zhi-ye-xue-yuan.md
      - 潍坊医学院: universities/wei-fang-yi-xue-yuan.md
      - 潍坊学院: universities/wei-fang-xue-yuan.md
      - 潍坊护理职业学院: universities/wei-fang-hu-li-zhi-ye-xue-yuan.md
      - 潍坊理工学院: universities/wei-fang-li-gong-xue-yuan.md
      - 潍坊科技学院: universities/wei-fang-ke-ji-xue-yuan.md
      - 潍坊职业学院: universities/wei-fang-zhi-ye-xue-yuan.md
      - 潍坊职业学院滨海校区B区: universities/wei-fang-zhi-ye-xue-yuan-bin-hai-xiao-qu-bqu.md
      - 烟台南山学院: universities/yan-tai-nan-shan-xue-yuan.md
      - 烟台大学: universities/yan-tai-da-xue.md
      - 烟台大学八角湾校区: universities/yan-tai-da-xue-ba-jiao-wan-xiao-qu.md
      - 烟台汽车工程职业学院: universities/yan-tai-qi-che-gong-cheng-zhi-ye-xue-yuan.md
      - 烟台理工学院: universities/yan-tai-li-gong-xue-yuan.md
      - 烟台科技学院: universities/yan-tai-ke-ji-xue-yuan.md
      - 烟台科技学院原济南大学泉城学院: universities/yan-tai-ke-ji-xue-yuan-yuan-ji-nan-da-xue-quan-cheng-xue-yuan.md
      - 烟台职业学院: universities/yan-tai-zhi-ye-xue-yuan.md
      - 烟台黄金职业学院: universities/yan-tai-huang-jin-zhi-ye-xue-yuan.md
      - 聊城大学: universities/liao-cheng-da-xue.md
      - 聊城大学东昌学院: universities/liao-cheng-da-xue-dong-chang-xue-yuan.md
      - 聊城职业技术学院: universities/liao-cheng-zhi-ye-ji-zhu-xue-yuan.md
      - 莱芜职业技术学院: universities/lai-wu-zhi-ye-ji-zhu-xue-yuan.md
      - 菏泽医学专科学校: universities/he-ze-yi-xue-zhuan-ke-xue-xiao.md
      - 菏泽学院: universities/he-ze-xue-yuan.md
      - 菏泽职业学院: universities/he-ze-zhi-ye-xue-yuan.md
      - 青岛农业大学: universities/qing-dao-nong-ye-da-xue.md
      - 青岛农业大学海都学院: universities/qing-dao-nong-ye-da-xue-hai-du-xue-yuan.md
      - 青岛城市学院: universities/qing-dao-cheng-shi-xue-yuan.md
      - 青岛大学: universities/qing-dao-da-xue.md
      - 青岛工学院: universities/qing-dao-gong-xue-yuan.md
      - 青岛恒星科技学院: universities/qing-dao-heng-xing-ke-ji-xue-yuan.md
      - 青岛港湾职业技术学院: universities/qing-dao-gang-wan-zhi-ye-ji-zhu-xue-yuan.md
      - 青岛滨海学院: universities/qing-dao-bin-hai-xue-yuan.md
      - 青岛理工大学: universities/qing-dao-li-gong-da-xue.md
      - 青岛理工大学临沂校区: universities/qing-dao-li-gong-da-xue-lin-yi-xiao-qu.md
      - 青岛理工大学嘉临江路校区: universities/qing-dao-li-gong-da-xue-jia-lin-jiang-lu-xiao-qu.md
      - 青岛理工大学市北校区: universities/qing-dao-li-gong-da-xue-shi-bei-xiao-qu.md
      - 青岛理工大学黄岛校区: universities/qing-dao-li-gong-da-xue-huang-dao-xiao-qu.md
      - 青岛电影学院: universities/qing-dao-dian-ying-xue-yuan.md
      - 青岛科技大学: universities/qing-dao-ke-ji-da-xue.md
      - 青岛科技大学高密校区: universities/qing-dao-ke-ji-da-xue-gao-mi-xiao-qu.md
      - 青岛黄海学院: universities/qing-dao-huang-hai-xue-yuan.md
      - 鲁东大学: universities/lu-dong-da-xue.md
      - 齐鲁医药学院: universities/qi-lu-yi-yao-xue-yuan.md
      - 齐鲁工业大学: universities/qi-lu-gong-ye-da-xue.md
      - 齐鲁工业大学山东省科学院: universities/qi-lu-gong-ye-da-xue-shan-dong-sheng-ke-xue-yuan.md
      - 齐鲁工业大学山东省科学院菏泽校区分院: universities/qi-lu-gong-ye-da-xue-shan-dong-sheng-ke-xue-yuan-he-ze-xiao-qu-fen-yuan.md
      - 齐鲁工业大学山东省科学院长清校区: universities/qi-lu-gong-ye-da-xue-shan-dong-sheng-ke-xue-yuan-chang-qing-xiao-qu.md
      - 齐鲁工业大学长清校区: universities/qi-lu-gong-ye-da-xue-chang-qing-xiao-qu.md
      - 齐鲁师范学院: universities/qi-lu-shi-fan-xue-yuan.md
      - 齐鲁理工学院: universities/qi-lu-li-gong-xue-yuan.md
    - 河南:
      - 三门峡职业技术学院: universities/san-men-xia-zhi-ye-ji-zhu-xue-yuan.md
      - 中原工学院: universities/zhong-yuan-gong-xue-yuan.md
      - 中原科技学院: universities/zhong-yuan-ke-ji-xue-yuan.md
      - 信阳农林学院: universities/xin-yang-nong-lin-xue-yuan.md
      - 信阳学院: universities/xin-yang-xue-yuan.md
      - 信阳师范学院: universities/xin-yang-shi-fan-xue-yuan.md
      - 信阳师范学院淮河校区: universities/xin-yang-shi-fan-xue-yuan-huai-he-xiao-qu.md
      - 信阳职业技术学院: universities/xin-yang-zhi-ye-ji-zhu-xue-yuan.md
      - 信阳航空职业学院: universities/xin-yang-hang-kong-zhi-ye-xue-yuan.md
      - 信阳艺术职业学院: universities/xin-yang-yi-zhu-zhi-ye-xue-yuan.md
      - 兰考三农职业学院: universities/lan-kao-san-nong-zhi-ye-xue-yuan.md
      - 华北水利水电大学: universities/hua-bei-shui-li-shui-dian-da-xue.md
      - 华北水利水电大学花园校区: universities/hua-bei-shui-li-shui-dian-da-xue-hua-yuan-xiao-qu.md
      - 华北水利水电大学龙子湖校区: universities/hua-bei-shui-li-shui-dian-da-xue-long-zi-hu-xiao-qu.md
      - 南阳医学高等专科学校: universities/nan-yang-yi-xue-gao-deng-zhuan-ke-xue-xiao.md
      - 南阳师范学院: universities/nan-yang-shi-fan-xue-yuan.md
      - 南阳理工学院: universities/nan-yang-li-gong-xue-yuan.md
      - 南阳科技职业学院: universities/nan-yang-ke-ji-zhi-ye-xue-yuan.md
      - 周口师范学院: universities/zhou-kou-shi-fan-xue-yuan.md
      - 周口文理职业学院: universities/zhou-kou-wen-li-zhi-ye-xue-yuan.md
      - 周口职业技术学院: universities/zhou-kou-zhi-ye-ji-zhu-xue-yuan.md
      - 商丘学院: universities/shang-qiu-xue-yuan.md
      - 商丘工学院: universities/shang-qiu-gong-xue-yuan.md
      - 商丘师范学院: universities/shang-qiu-shi-fan-xue-yuan.md
      - 安阳学院: universities/an-yang-xue-yuan.md
      - 安阳学院原阳校区: universities/an-yang-xue-yuan-yuan-yang-xiao-qu.md
      - 安阳工学院: universities/an-yang-gong-xue-yuan.md
      - 安阳师范学院: universities/an-yang-shi-fan-xue-yuan.md
      - 安阳职业技术学院: universities/an-yang-zhi-ye-ji-zhu-xue-yuan.md
      - 平顶山学院: universities/ping-ding-shan-xue-yuan.md
      - 平顶山工业职业技术学院: universities/ping-ding-shan-gong-ye-zhi-ye-ji-zhu-xue-yuan.md
      - 平顶山职业技术学院新校区: universities/ping-ding-shan-zhi-ye-ji-zhu-xue-yuan-xin-xiao-qu.md
      - 开封大学: universities/kai-feng-da-xue.md
      - 新乡医学院: universities/xin-xiang-yi-xue-yuan.md
      - 新乡医学院三全学院: universities/xin-xiang-yi-xue-yuan-san-quan-xue-yuan.md
      - 新乡医学院三全学院平原校区: universities/xin-xiang-yi-xue-yuan-san-quan-xue-yuan-ping-yuan-xiao-qu.md
      - 新乡学院: universities/xin-xiang-xue-yuan.md
      - 新乡工程学院: universities/xin-xiang-gong-cheng-xue-yuan.md
      - 新乡职业技术学院: universities/xin-xiang-zhi-ye-ji-zhu-xue-yuan.md
      - 林州建筑职业技术学院: universities/lin-zhou-jian-zhu-zhi-ye-ji-zhu-xue-yuan.md
      - 河南中医药大学: universities/he-nan-zhong-yi-yao-da-xue.md
      - 河南中医药大学龙子湖校区: universities/he-nan-zhong-yi-yao-da-xue-long-zi-hu-xiao-qu.md
      - 河南交通职业技术学院: universities/he-nan-jiao-tong-zhi-ye-ji-zhu-xue-yuan.md
      - 河南信息统计职业学院: universities/he-nan-xin-xi-tong-ji-zhi-ye-xue-yuan.md
      - 河南农业大学: universities/he-nan-nong-ye-da-xue.md
      - 河南农业大学龙子湖: universities/he-nan-nong-ye-da-xue-long-zi-hu.md
      - 河南农业职业学院: universities/he-nan-nong-ye-zhi-ye-xue-yuan.md
      - 河南医学高等专科学校: universities/he-nan-yi-xue-gao-deng-zhuan-ke-xue-xiao.md
      - 河南司法警官职业学院: universities/he-nan-si-fa-jing-guan-zhi-ye-xue-yuan.md
      - 河南城建学院: universities/he-nan-cheng-jian-xue-yuan.md
      - 河南大学: universities/he-nan-da-xue.md
      - 河南大学郑州校区: universities/he-nan-da-xue-zheng-zhou-xiao-qu.md
      - 河南女子职业学院: universities/he-nan-nu-zi-zhi-ye-xue-yuan.md
      - 河南工业和信息化职业学院: universities/he-nan-gong-ye-he-xin-xi-hua-zhi-ye-xue-yuan.md
      - 河南工业大学: universities/he-nan-gong-ye-da-xue.md
      - 河南工业职业技术学院: universities/he-nan-gong-ye-zhi-ye-ji-zhu-xue-yuan.md
      - 河南工学院: universities/he-nan-gong-xue-yuan.md
      - 河南工程学院: universities/he-nan-gong-cheng-xue-yuan.md
      - 河南工程学院南阳路校区: universities/he-nan-gong-cheng-xue-yuan-nan-yang-lu-xiao-qu.md
      - 河南师范大学: universities/he-nan-shi-fan-da-xue.md
      - 河南开封科技传媒学院: universities/he-nan-kai-feng-ke-ji-chuan-mei-xue-yuan.md
      - 河南护理职业学院: universities/he-nan-hu-li-zhi-ye-xue-yuan.md
      - 河南推拿职业学院: universities/he-nan-tui-na-zhi-ye-xue-yuan.md
      - 河南林业职业学院: universities/he-nan-lin-ye-zhi-ye-xue-yuan.md
      - 河南水利与环境职业学院: universities/he-nan-shui-li-yu-huan-jing-zhi-ye-xue-yuan.md
      - 河南牧业经济学院: universities/he-nan-mu-ye-jing-ji-xue-yuan.md
      - 河南牧业经济学院英才校区: universities/he-nan-mu-ye-jing-ji-xue-yuan-ying-cai-xiao-qu.md
      - 河南物流职业学院: universities/he-nan-wu-liu-zhi-ye-xue-yuan.md
      - 河南理工大学: universities/he-nan-li-gong-da-xue.md
      - 河南理工大学鹤壁工程技术学院: universities/he-nan-li-gong-da-xue-he-bi-gong-cheng-ji-zhu-xue-yuan.md
      - 河南科技大学: universities/he-nan-ke-ji-da-xue.md
      - 河南科技大学开元校区: universities/he-nan-ke-ji-da-xue-kai-yuan-xiao-qu.md
      - 河南科技大学西苑校区: universities/he-nan-ke-ji-da-xue-xi-yuan-xiao-qu.md
      - 河南科技学院: universities/he-nan-ke-ji-xue-yuan.md
      - 河南科技职业大学: universities/he-nan-ke-ji-zhi-ye-da-xue.md
      - 河南经贸职业学院: universities/he-nan-jing-mao-zhi-ye-xue-yuan.md
      - 河南职业技术学院: universities/he-nan-zhi-ye-ji-zhu-xue-yuan.md
      - 河南艺术职业学院: universities/he-nan-yi-zhu-zhi-ye-xue-yuan.md
      - 河南警察学院: universities/he-nan-jing-cha-xue-yuan.md
      - 河南财政金融学院: universities/he-nan-cai-zheng-jin-rong-xue-yuan.md
      - 河南财政金融学院龙子湖校区: universities/he-nan-cai-zheng-jin-rong-xue-yuan-long-zi-hu-xiao-qu.md
      - 河南财经政法大学: universities/he-nan-cai-jing-zheng-fa-da-xue.md
      - 河南财经政法大学郑东校区: universities/he-nan-cai-jing-zheng-fa-da-xue-zheng-dong-xiao-qu.md
      - 河南质量工程职业学院: universities/he-nan-zhi-liang-gong-cheng-zhi-ye-xue-yuan.md
      - 洛阳师范学院: universities/luo-yang-shi-fan-xue-yuan.md
      - 洛阳理工学院: universities/luo-yang-li-gong-xue-yuan.md
      - 济源职业技术学院: universities/ji-yuan-zhi-ye-ji-zhu-xue-yuan.md
      - 漯河医学高等专科学校: universities/lei-he-yi-xue-gao-deng-zhuan-ke-xue-xiao.md
      - 漯河职业技术学院: universities/lei-he-zhi-ye-ji-zhu-xue-yuan.md
      - 濮阳医学高等专科学校: universities/pu-yang-yi-xue-gao-deng-zhuan-ke-xue-xiao.md
      - 濮阳职业技术学院: universities/pu-yang-zhi-ye-ji-zhu-xue-yuan.md
      - 焦作大学: universities/jiao-zuo-da-xue.md
      - 焦作师范高等专科学校: universities/jiao-zuo-shi-fan-gao-deng-zhuan-ke-xue-xiao.md
      - 焦作师范高等专科学校新校区: universities/jiao-zuo-shi-fan-gao-deng-zhuan-ke-xue-xiao-xin-xiao-qu.md
      - 许昌学院: universities/xu-chang-xue-yuan.md
      - 许昌电气职业学院: universities/xu-chang-dian-qi-zhi-ye-xue-yuan.md
      - 郑州信息工程职业学院: universities/zheng-zhou-xin-xi-gong-cheng-zhi-ye-xue-yuan.md
      - 郑州信息科技职业学院河南开放大学: universities/zheng-zhou-xin-xi-ke-ji-zhi-ye-xue-yuan-he-nan-kai-fang-da-xue.md
      - 郑州升达经贸管理学院: universities/zheng-zhou-sheng-da-jing-mao-guan-li-xue-yuan.md
      - 郑州商学院: universities/zheng-zhou-shang-xue-yuan.md
      - 郑州大学: universities/zheng-zhou-da-xue.md
      - 郑州大学北校区: universities/zheng-zhou-da-xue-bei-xiao-qu.md
      - 郑州工业安全职业学院: universities/zheng-zhou-gong-ye-an-quan-zhi-ye-xue-yuan.md
      - 郑州工业应用技术学院: universities/zheng-zhou-gong-ye-ying-yong-ji-zhu-xue-yuan.md
      - 郑州工商学院: universities/zheng-zhou-gong-shang-xue-yuan.md
      - 郑州工程技术学院: universities/zheng-zhou-gong-cheng-ji-zhu-xue-yuan.md
      - 郑州师范学院: universities/zheng-zhou-shi-fan-xue-yuan.md
      - 郑州幼儿师范高等专科学校: universities/zheng-zhou-you-er-shi-fan-gao-deng-zhuan-ke-xue-xiao.md
      - 郑州旅游职业学院: universities/zheng-zhou-lu-you-zhi-ye-xue-yuan.md
      - 郑州澍青医学高等专科学校: universities/zheng-zhou-shu-qing-yi-xue-gao-deng-zhuan-ke-xue-xiao.md
      - 郑州电力高等专科学校: universities/zheng-zhou-dian-li-gao-deng-zhuan-ke-xue-xiao.md
      - 郑州电子商务职业学院: universities/zheng-zhou-dian-zi-shang-wu-zhi-ye-xue-yuan.md
      - 郑州科技学院: universities/zheng-zhou-ke-ji-xue-yuan.md
      - 郑州经贸学院: universities/zheng-zhou-jing-mao-xue-yuan.md
      - 郑州职业技术学院: universities/zheng-zhou-zhi-ye-ji-zhu-xue-yuan.md
      - 郑州航空工业管理学院: universities/zheng-zhou-hang-kong-gong-ye-guan-li-xue-yuan.md
      - 郑州西亚斯学院: universities/zheng-zhou-xi-ya-si-xue-yuan.md
      - 郑州西亚斯学院数字技术产业学院: universities/zheng-zhou-xi-ya-si-xue-yuan-shu-zi-ji-zhu-chan-ye-xue-yuan.md
      - 郑州警察学院原铁道警察学院: universities/zheng-zhou-jing-cha-xue-yuan-yuan-tie-dao-jing-cha-xue-yuan.md
      - 郑州财税金融职业学院: universities/zheng-zhou-cai-shui-jin-rong-zhi-ye-xue-yuan.md
      - 郑州财经学院: universities/zheng-zhou-cai-jing-xue-yuan.md
      - 郑州轨道工程职业学院: universities/zheng-zhou-gui-dao-gong-cheng-zhi-ye-xue-yuan.md
      - 郑州轻工业大学: universities/zheng-zhou-qing-gong-ye-da-xue.md
      - 郑州铁路职业技术学院: universities/zheng-zhou-tie-lu-zhi-ye-ji-zhu-xue-yuan.md
      - 长垣烹饪职业技术学院: universities/chang-yuan-peng-ren-zhi-ye-ji-zhu-xue-yuan.md
      - 驻马店职业技术学院: universities/zhu-ma-dian-zhi-ye-ji-zhu-xue-yuan.md
      - 鹤壁汽车工程职业学院: universities/he-bi-qi-che-gong-cheng-zhi-ye-xue-yuan.md
      - 鹤壁职业技术学院: universities/he-bi-zhi-ye-ji-zhu-xue-yuan.md
      - 鹤壁能源化工职业学院: universities/he-bi-neng-yuan-hua-gong-zhi-ye-xue-yuan.md
      - 黄河交通学院: universities/huang-he-jiao-tong-xue-yuan.md
      - 黄河水利职业技术学院: universities/huang-he-shui-li-zhi-ye-ji-zhu-xue-yuan.md
      - 黄河科技学院: universities/huang-he-ke-ji-xue-yuan.md
      - 黄河科技学院应用技术学院: universities/huang-he-ke-ji-xue-yuan-ying-yong-ji-zhu-xue-yuan.md
      - 黄淮学院: universities/huang-huai-xue-yuan.md
    - 湖北:
      - 三峡大学: universities/san-xia-da-xue.md
      - 三峡大学科技学院: universities/san-xia-da-xue-ke-ji-xue-yuan.md
      - 三峡电力职业学院: universities/san-xia-dian-li-zhi-ye-xue-yuan.md
      - 中南民族大学: universities/zhong-nan-min-zu-da-xue.md
      - 中南财经政法大学: universities/zhong-nan-cai-jing-zheng-fa-da-xue.md
      - 中国地质大学武汉: universities/zhong-guo-di-zhi-da-xue-wu-yi.md
      - 仙桃职业学院: universities/xian-tao-zhi-ye-xue-yuan.md
      - 华中农业大学: universities/hua-zhong-nong-ye-da-xue.md
      - 华中师范大学: universities/hua-zhong-shi-fan-da-xue.md
      - 华中科技大学: universities/hua-zhong-ke-ji-da-xue.md
      - 华中科技大学同济医学院: universities/hua-zhong-ke-ji-da-xue-tong-ji-yi-xue-yuan.md
      - 华中科技大学文华学院: universities/hua-zhong-ke-ji-da-xue-wen-hua-xue-yuan.md
      - 华中科技大学网络空间安全学院校区: universities/hua-zhong-ke-ji-da-xue-wang-luo-kong-jian-an-quan-xue-yuan-xiao-qu.md
      - 咸宁职业技术学院: universities/xian-zhu-zhi-ye-ji-zhu-xue-yuan.md
      - 国立武汉大学/武汉大学: universities/guo-li-wu-yi-da-xue-wu-yi-da-xue.md
      - 恩施职业技术学院: universities/en-shi-zhi-ye-ji-zhu-xue-yuan.md
      - 文华学院: universities/wen-hua-xue-yuan.md
      - 武昌工学院: universities/wu-chang-gong-xue-yuan.md
      - 武昌理工学院: universities/wu-chang-li-gong-xue-yuan.md
      - 武昌职业学院: universities/wu-chang-zhi-ye-xue-yuan.md
      - 武昌首义学院: universities/wu-chang-shou-yi-xue-yuan.md
      - 武昌首义学院嘉鱼校区: universities/wu-chang-shou-yi-xue-yuan-jia-yu-xiao-qu.md
      - 武汉东湖学院: universities/wu-yi-dong-hu-xue-yuan.md
      - 武汉交通职业学院: universities/wu-yi-jiao-tong-zhi-ye-xue-yuan.md
      - 武汉传媒学院: universities/wu-yi-chuan-mei-xue-yuan.md
      - 武汉体育学院: universities/wu-yi-ti-yu-xue-yuan.md
      - 武汉信息传播职业技术学院: universities/wu-yi-xin-xi-chuan-bo-zhi-ye-ji-zhu-xue-yuan.md
      - 武汉光谷职业学院: universities/wu-yi-guang-gu-zhi-ye-xue-yuan.md
      - 武汉华夏理工学院: universities/wu-yi-hua-xia-li-gong-xue-yuan.md
      - 武汉商学院: universities/wu-yi-shang-xue-yuan.md
      - 武汉商贸职业学院: universities/wu-yi-shang-mao-zhi-ye-xue-yuan.md
      - 武汉城市学院: universities/wu-yi-cheng-shi-xue-yuan.md
      - 武汉大学: universities/wu-yi-da-xue.md
      - 武汉大学信息学部: universities/wu-yi-da-xue-xin-xi-xue-bu.md
      - 武汉学院: universities/wu-yi-xue-yuan-2.md
      - 武汉工商学院: universities/wu-yi-gong-shang-xue-yuan.md
      - 武汉工程大学: universities/wu-yi-gong-cheng-da-xue.md
      - 武汉工程大学流芳校区: universities/wu-yi-gong-cheng-da-xue-liu-fang-xiao-qu.md
      - 武汉工程大学邮电与信息工程学院: universities/wu-yi-gong-cheng-da-xue-you-dian-yu-xin-xi-gong-cheng-xue-yuan.md
      - 武汉工程科技学院: universities/wu-yi-gong-cheng-ke-ji-xue-yuan.md
      - 武汉工程职业技术学院: universities/wu-yi-gong-cheng-zhi-ye-ji-zhu-xue-yuan.md
      - 武汉文理学院: universities/wu-yi-wen-li-xue-yuan.md
      - 武汉晴川学院: universities/wu-yi-qing-chuan-xue-yuan.md
      - 武汉海事职业学院: universities/wu-yi-hai-shi-zhi-ye-xue-yuan.md
      - 武汉理工大学: universities/wu-yi-li-gong-da-xue.md
      - 武汉理工大学南湖校区: universities/wu-yi-li-gong-da-xue-nan-hu-xiao-qu.md
      - 武汉生物工程学院: universities/wu-yi-sheng-wu-gong-cheng-xue-yuan.md
      - 武汉电力职业技术学院: universities/wu-yi-dian-li-zhi-ye-ji-zhu-xue-yuan.md
      - 武汉科技大学: universities/wu-yi-ke-ji-da-xue.md
      - 武汉纺织大学: universities/wu-yi-fang-zhi-da-xue.md
      - 武汉纺织大学南湖校区: universities/wu-yi-fang-zhi-da-xue-nan-hu-xiao-qu.md
      - 武汉纺织大学外经贸学院: universities/wu-yi-fang-zhi-da-xue-wai-jing-mao-xue-yuan.md
      - 武汉纺织大学阳光校区: universities/wu-yi-fang-zhi-da-xue-yang-guang-xiao-qu.md
      - 武汉职业技术学院: universities/wu-yi-zhi-ye-ji-zhu-xue-yuan.md
      - 武汉船舶职业技术学院: universities/wu-yi-chuan-bo-zhi-ye-ji-zhu-xue-yuan.md
      - 武汉警官职业学院: universities/wu-yi-jing-guan-zhi-ye-xue-yuan.md
      - 武汉软件工程职业学院: universities/wu-yi-ruan-jian-gong-cheng-zhi-ye-xue-yuan.md
      - 武汉轻工大学: universities/wu-yi-qing-gong-da-xue.md
      - 武汉铁路职业技术学院: universities/wu-yi-tie-lu-zhi-ye-ji-zhu-xue-yuan.md
      - 武汉音乐学院: universities/wu-yi-yin-le-xue-yuan.md
      - 汉口学院: universities/yi-kou-xue-yuan.md
      - 江汉大学: universities/jiang-yi-da-xue.md
      - 江汉艺术职业学院: universities/jiang-yi-yi-zhu-zhi-ye-xue-yuan.md
      - 海军工程大学: universities/hai-jun-gong-cheng-da-xue.md
      - 湖北三峡职业技术学院: universities/hu-bei-san-xia-zhi-ye-ji-zhu-xue-yuan.md
      - 湖北中医药大学: universities/hu-bei-zhong-yi-yao-da-xue.md
      - 湖北交通职业技术学院: universities/hu-bei-jiao-tong-zhi-ye-ji-zhu-xue-yuan.md
      - 湖北交通职业技术学院藏龙岛校区: universities/hu-bei-jiao-tong-zhi-ye-ji-zhu-xue-yuan-cang-long-dao-xiao-qu.md
      - 湖北健康职业学院: universities/hu-bei-jian-kang-zhi-ye-xue-yuan.md
      - 湖北医药学院: universities/hu-bei-yi-yao-xue-yuan.md
      - 湖北城市建设职业技术学院: universities/hu-bei-cheng-shi-jian-she-zhi-ye-ji-zhu-xue-yuan.md
      - 湖北大学: universities/hu-bei-da-xue.md
      - 湖北大学知行学院: universities/hu-bei-da-xue-zhi-xing-xue-yuan.md
      - 湖北工业大学: universities/hu-bei-gong-ye-da-xue.md
      - 湖北工业大学工程技术学院: universities/hu-bei-gong-ye-da-xue-gong-cheng-ji-zhu-xue-yuan.md
      - 湖北工业职业技术学院: universities/hu-bei-gong-ye-zhi-ye-ji-zhu-xue-yuan.md
      - 湖北工程学院: universities/hu-bei-gong-cheng-xue-yuan.md
      - 湖北工程学院新技术学院: universities/hu-bei-gong-cheng-xue-yuan-xin-ji-zhu-xue-yuan.md
      - 湖北工程职业学院新校区: universities/hu-bei-gong-cheng-zhi-ye-xue-yuan-xin-xiao-qu.md
      - 湖北师范大学: universities/hu-bei-shi-fan-da-xue.md
      - 湖北师范大学文理学院: universities/hu-bei-shi-fan-da-xue-wen-li-xue-yuan.md
      - 湖北幼儿师范高等专科学校: universities/hu-bei-you-er-shi-fan-gao-deng-zhuan-ke-xue-xiao.md
      - 湖北恩施学院: universities/hu-bei-en-shi-xue-yuan.md
      - 湖北文理学院: universities/hu-bei-wen-li-xue-yuan.md
      - 湖北民族大学: universities/hu-bei-min-zu-da-xue.md
      - 湖北水利水电职业技术学院汤逊湖校区: universities/hu-bei-shui-li-shui-dian-zhi-ye-ji-zhu-xue-yuan-tang-xun-hu-xiao-qu.md
      - 湖北汽车工业学院: universities/hu-bei-qi-che-gong-ye-xue-yuan.md
      - 湖北理工学院: universities/hu-bei-li-gong-xue-yuan.md
      - 湖北生态工程职业技术学院: universities/hu-bei-sheng-tai-gong-cheng-zhi-ye-ji-zhu-xue-yuan.md
      - 湖北生物科技职业学院: universities/hu-bei-sheng-wu-ke-ji-zhi-ye-xue-yuan.md
      - 湖北科技学院: universities/hu-bei-ke-ji-xue-yuan.md
      - 湖北科技职业学院: universities/hu-bei-ke-ji-zhi-ye-xue-yuan.md
      - 湖北第二师范学院: universities/hu-bei-di-er-shi-fan-xue-yuan.md
      - 湖北经济学院: universities/hu-bei-jing-ji-xue-yuan.md
      - 湖北经济学院法商学院: universities/hu-bei-jing-ji-xue-yuan-fa-shang-xue-yuan.md
      - 湖北美术学院: universities/hu-bei-mei-shu-xue-yuan.md
      - 湖北轻工职业技术学院: universities/hu-bei-qing-gong-zhi-ye-ji-zhu-xue-yuan.md
      - 湖北铁道运输职业学院: universities/hu-bei-tie-dao-yun-shu-zhi-ye-xue-yuan.md
      - 荆州学院: universities/jing-zhou-xue-yuan.md
      - 荆州理工职业学院: universities/jing-zhou-li-gong-zhi-ye-xue-yuan.md
      - 荆州理工职业学院东校区: universities/jing-zhou-li-gong-zhi-ye-xue-yuan-dong-xiao-qu.md
      - 荆州职业技术学院: universities/jing-zhou-zhi-ye-ji-zhu-xue-yuan.md
      - 荆楚理工学院: universities/jing-chu-li-gong-xue-yuan.md
      - 鄂州职业大学: universities/e-zhou-zhi-ye-da-xue.md
      - 长江大学: universities/chang-jiang-da-xue.md
      - 长江大学文理学院: universities/chang-jiang-da-xue-wen-li-xue-yuan.md
      - 长江大学武汉: universities/chang-jiang-da-xue-wu-yi.md
      - 长江艺术工程职业学院: universities/chang-jiang-yi-zhu-gong-cheng-zhi-ye-xue-yuan.md
      - 黄冈师范学院: universities/huang-gang-shi-fan-xue-yuan.md
    - 湖南:
      - 中南大学: universities/zhong-nan-da-xue.md
      - 中南林业科技大学: universities/zhong-nan-lin-ye-ke-ji-da-xue.md
      - 中南林业科技大学涉外学院: universities/zhong-nan-lin-ye-ke-ji-da-xue-she-wai-xue-yuan.md
      - 中国人民解放军国防科技大学: universities/zhong-guo-ren-min-jie-fang-jun-guo-fang-ke-ji-da-xue.md
      - 南华大学: universities/nan-hua-da-xue.md
      - 南华大学雨母校区: universities/nan-hua-da-xue-yu-mu-xiao-qu.md
      - 吉首大学: universities/ji-shou-da-xue.md
      - 吉首大学张家界学院: universities/ji-shou-da-xue-zhang-jia-jie-xue-yuan.md
      - 吉首大学砂子坳校区: universities/ji-shou-da-xue-sha-zi-ao-xiao-qu.md
      - 吉首大学雷公井校区: universities/ji-shou-da-xue-lei-gong-jing-xiao-qu.md
      - 国防科技大学: universities/guo-fang-ke-ji-da-xue.md
      - 娄底职业技术学院: universities/lou-di-zhi-ye-ji-zhu-xue-yuan.md
      - 岳阳职业技术学院: universities/yue-yang-zhi-ye-ji-zhu-xue-yuan.md
      - 张家界航空工业职业技术学院: universities/zhang-jia-jie-hang-kong-gong-ye-zhi-ye-ji-zhu-xue-yuan.md
      - 怀化学院: universities/huai-hua-xue-yuan.md
      - 怀化职业技术学院: universities/huai-hua-zhi-ye-ji-zhu-xue-yuan.md
      - 湖南中医药大学: universities/hu-nan-zhong-yi-yao-da-xue.md
      - 湖南中医药大学含浦校区: universities/hu-nan-zhong-yi-yao-da-xue-han-pu-xiao-qu.md
      - 湖南中医药大学湘杏学院湘阴校区: universities/hu-nan-zhong-yi-yao-da-xue-xiang-xing-xue-yuan-xiang-yin-xiao-qu.md
      - 湖南交通工程学院: universities/hu-nan-jiao-tong-gong-cheng-xue-yuan.md
      - 湖南交通职业技术学院: universities/hu-nan-jiao-tong-zhi-ye-ji-zhu-xue-yuan.md
      - 湖南人文科技学院: universities/hu-nan-ren-wen-ke-ji-xue-yuan.md
      - 湖南信息学院: universities/hu-nan-xin-xi-xue-yuan.md
      - 湖南信息职业技术学院: universities/hu-nan-xin-xi-zhi-ye-ji-zhu-xue-yuan.md
      - 湖南农业大学: universities/hu-nan-nong-ye-da-xue.md
      - 湖南农业大学东方科技学院: universities/hu-nan-nong-ye-da-xue-dong-fang-ke-ji-xue-yuan.md
      - 湖南化工职业技术学院: universities/hu-nan-hua-gong-zhi-ye-ji-zhu-xue-yuan.md
      - 湖南医药学院: universities/hu-nan-yi-yao-xue-yuan.md
      - 湖南商务职业技术学院: universities/hu-nan-shang-wu-zhi-ye-ji-zhu-xue-yuan.md
      - 湖南城市学院: universities/hu-nan-cheng-shi-xue-yuan.md
      - 湖南外国语职业学院: universities/hu-nan-wai-guo-yu-zhi-ye-xue-yuan.md
      - 湖南大众传媒职业技术学院: universities/hu-nan-da-zhong-chuan-mei-zhi-ye-ji-zhu-xue-yuan.md
      - 湖南大学: universities/hu-nan-da-xue.md
      - 湖南女子学院: universities/hu-nan-nu-zi-xue-yuan.md
      - 湖南工业大学: universities/hu-nan-gong-ye-da-xue.md
      - 湖南工业大学科技学院: universities/hu-nan-gong-ye-da-xue-ke-ji-xue-yuan.md
      - 湖南工业职业技术学院: universities/hu-nan-gong-ye-zhi-ye-ji-zhu-xue-yuan.md
      - 湖南工商大学: universities/hu-nan-gong-shang-da-xue.md
      - 湖南工学院: universities/hu-nan-gong-xue-yuan.md
      - 湖南工程学院: universities/hu-nan-gong-cheng-xue-yuan.md
      - 湖南工程职业技术学院: universities/hu-nan-gong-cheng-zhi-ye-ji-zhu-xue-yuan.md
      - 湖南工艺美术职业学院: universities/hu-nan-gong-yi-mei-shu-zhi-ye-xue-yuan.md
      - 湖南师范大学: universities/hu-nan-shi-fan-da-xue.md
      - 湖南应用技术学院: universities/hu-nan-ying-yong-ji-zhu-xue-yuan.md
      - 湖南文理学院: universities/hu-nan-wen-li-xue-yuan.md
      - 湖南有色金属职业技术学院: universities/hu-nan-you-se-jin-shu-zhi-ye-ji-zhu-xue-yuan.md
      - 湖南机电职业技术学院: universities/hu-nan-ji-dian-zhi-ye-ji-zhu-xue-yuan.md
      - 湖南汽车工程职业学院: universities/hu-nan-qi-che-gong-cheng-zhi-ye-xue-yuan.md
      - 湖南涉外经济学院: universities/hu-nan-she-wai-jing-ji-xue-yuan.md
      - 湖南环境生物职业技术学院: universities/hu-nan-huan-jing-sheng-wu-zhi-ye-ji-zhu-xue-yuan.md
      - 湖南现代物流职业技术学院: universities/hu-nan-xian-dai-wu-liu-zhi-ye-ji-zhu-xue-yuan.md
      - 湖南理工学院: universities/hu-nan-li-gong-xue-yuan.md
      - 湖南生物机电职业技术学院: universities/hu-nan-sheng-wu-ji-dian-zhi-ye-ji-zhu-xue-yuan.md
      - 湖南石油化工职业技术学院: universities/hu-nan-shi-you-hua-gong-zhi-ye-ji-zhu-xue-yuan.md
      - 湖南科技大学: universities/hu-nan-ke-ji-da-xue.md
      - 湖南科技学院: universities/hu-nan-ke-ji-xue-yuan.md
      - 湖南科技职业学院: universities/hu-nan-ke-ji-zhi-ye-xue-yuan.md
      - 湖南第一师范学院: universities/hu-nan-di-yi-shi-fan-xue-yuan.md
      - 湖南网络工程职业学院: universities/hu-nan-wang-luo-gong-cheng-zhi-ye-xue-yuan.md
      - 湖南警察学院: universities/hu-nan-jing-cha-xue-yuan.md
      - 湖南财政经济学院: universities/hu-nan-cai-zheng-jing-ji-xue-yuan.md
      - 湖南财政经济学院雷锋学院: universities/hu-nan-cai-zheng-jing-ji-xue-yuan-lei-feng-xue-yuan.md
      - 湖南财政经济学院雷锋校区: universities/hu-nan-cai-zheng-jing-ji-xue-yuan-lei-feng-xiao-qu.md
      - 湖南财经工业职业技术学院: universities/hu-nan-cai-jing-gong-ye-zhi-ye-ji-zhu-xue-yuan.md
      - 湖南都市职业学院: universities/hu-nan-du-shi-zhi-ye-xue-yuan.md
      - 湖南铁道职业技术学院: universities/hu-nan-tie-dao-zhi-ye-ji-zhu-xue-yuan.md
      - 湖南高速铁路职业技术学院: universities/hu-nan-gao-su-tie-lu-zhi-ye-ji-zhu-xue-yuan.md
      - 湘南学院: universities/xiang-nan-xue-yuan.md
      - 湘潭医卫职业技术学院: universities/xiang-tan-yi-wei-zhi-ye-ji-zhu-xue-yuan.md
      - 湘潭大学: universities/xiang-tan-da-xue.md
      - 益阳职业技术学院: universities/yi-yang-zhi-ye-ji-zhu-xue-yuan.md
      - 衡阳师范学院: universities/heng-yang-shi-fan-xue-yuan.md
      - 衡阳师范学院东校区: universities/heng-yang-shi-fan-xue-yuan-dong-xiao-qu.md
      - 衡阳师范学院南岳学院新校区: universities/heng-yang-shi-fan-xue-yuan-nan-yue-xue-yuan-xin-xiao-qu.md
      - 衡阳幼儿师范高等专科学校: universities/heng-yang-you-er-shi-fan-gao-deng-zhuan-ke-xue-xiao.md
      - 邵阳学院: universities/shao-yang-xue-yuan.md
      - 邵阳学院李子园校区食品与化学工程学院，音乐与舞蹈学院，文学院，外国语学院在这个校区很小但很方便并且市中心近: universities/shao-yang-xue-yuan-li-zi-yuan-xiao-qu-shi-pin-yu-hua-xue-gong-cheng-xue-yuan-yin-le-yu-wu-dao-xue-yuan-wen-xue-yuan-wai-guo-yu-xue-yuan-zai-zhe-ge-xiao-qu-hen-xiao-dan-hen-fang-bian-bing-qie-shi-zhong-xin-jin.md
      - 郴州职业技术学院: universities/chen-zhou-zhi-ye-ji-zhu-xue-yuan.md
      - 长沙医学院: universities/chang-sha-yi-xue-yuan.md
      - 长沙卫生职业学院: universities/chang-sha-wei-sheng-zhi-ye-xue-yuan.md
      - 长沙商贸旅游职业技术学院: universities/chang-sha-shang-mao-lu-you-zhi-ye-ji-zhu-xue-yuan.md
      - 长沙学院: universities/chang-sha-xue-yuan.md
      - 长沙师范学院: universities/chang-sha-shi-fan-xue-yuan.md
      - 长沙幼儿师范高等专科学校: universities/chang-sha-you-er-shi-fan-gao-deng-zhuan-ke-xue-xiao.md
      - 长沙理工大学: universities/chang-sha-li-gong-da-xue.md
      - 长沙理工大学云塘校区: universities/chang-sha-li-gong-da-xue-yun-tang-xiao-qu.md
      - 长沙职业技术学院: universities/chang-sha-zhi-ye-ji-zhu-xue-yuan.md
      - 长沙航空职业技术学院: universities/chang-sha-hang-kong-zhi-ye-ji-zhu-xue-yuan.md
    - 广东:
      - 东莞城市学院: universities/dong-wan-cheng-shi-xue-yuan.md
      - 东莞理工学院: universities/dong-wan-li-gong-xue-yuan.md
      - 东莞理工学院城市学院: universities/dong-wan-li-gong-xue-yuan-cheng-shi-xue-yuan.md
      - 中国广东省佛山市禅城区佛山科学技术学院: universities/zhong-guo-yan-dong-sheng-fo-shan-shi-shan-cheng-qu-fo-shan-ke-xue-ji-zhu-xue-yuan.md
      - 中山大学: universities/zhong-shan-da-xue.md
      - 中山大学南校区: universities/zhong-shan-da-xue-nan-xiao-qu.md
      - 中山大学南校园: universities/zhong-shan-da-xue-nan-xiao-yuan.md
      - 中山大学珠海校区: universities/zhong-shan-da-xue-zhu-hai-xiao-qu.md
      - 五邑大学: universities/wu-yi-da-xue-2.md
      - 仲恺农业工程学院: universities/zhong-kai-nong-ye-gong-cheng-xue-yuan.md
      - 仲恺农业工程学院海珠校区: universities/zhong-kai-nong-ye-gong-cheng-xue-yuan-hai-zhu-xiao-qu.md
      - 佛山科学技术学院: universities/fo-shan-ke-xue-ji-zhu-xue-yuan.md
      - 北京师范大学-香港浸会大学联合国际学院: universities/bei-jing-shi-fan-da-xue-xiang-gang-jin-hui-da-xue-lian-he-guo-ji-xue-yuan.md
      - 北京师范大学珠海校区: universities/bei-jing-shi-fan-da-xue-zhu-hai-xiao-qu.md
      - 北京理工大学珠海学院: universities/bei-jing-li-gong-da-xue-zhu-hai-xue-yuan.md
      - 华南农业大学: universities/hua-nan-nong-ye-da-xue.md
      - 华南农业大学珠江学院: universities/hua-nan-nong-ye-da-xue-zhu-jiang-xue-yuan.md
      - 华南师范大学: universities/hua-nan-shi-fan-da-xue.md
      - 华南师范大学南海校区: universities/hua-nan-shi-fan-da-xue-nan-hai-xiao-qu.md
      - 华南师范大学大学城校区: universities/hua-nan-shi-fan-da-xue-da-xue-cheng-xiao-qu.md
      - 华南师范大学汕尾校区: universities/hua-nan-shi-fan-da-xue-shan-wei-xiao-qu.md
      - 华南师范大学石牌校区: universities/hua-nan-shi-fan-da-xue-shi-pai-xiao-qu.md
      - 华南理工大学: universities/hua-nan-li-gong-da-xue.md
      - 华南理工大学大学城校区: universities/hua-nan-li-gong-da-xue-da-xue-cheng-xiao-qu.md
      - 华南理工大学广州国际校区: universities/hua-nan-li-gong-da-xue-yan-zhou-guo-ji-xiao-qu.md
      - 南方医科大学: universities/nan-fang-yi-ke-da-xue.md
      - 南方科技大学: universities/nan-fang-ke-ji-da-xue.md
      - 哈尔滨工业大学深圳校区: universities/ha-er-bin-gong-ye-da-xue-shen-zhen-xiao-qu.md
      - 嘉应学院: universities/jia-ying-xue-yuan.md
      - 嘉应学院医学院: universities/jia-ying-xue-yuan-yi-xue-yuan.md
      - 岭南师范学院: universities/ling-nan-shi-fan-xue-yuan.md
      - 广东亚视演艺职业学院: universities/yan-dong-ya-shi-yan-yi-zhi-ye-xue-yuan.md
      - 广东交通职业技术学院: universities/yan-dong-jiao-tong-zhi-ye-ji-zhu-xue-yuan.md
      - 广东创新科技职业学院: universities/yan-dong-chuang-xin-ke-ji-zhi-ye-xue-yuan.md
      - 广东医科大学: universities/yan-dong-yi-ke-da-xue.md
      - 广东医科大学东莞校区: universities/yan-dong-yi-ke-da-xue-dong-wan-xiao-qu.md
      - 广东南方职业学院: universities/yan-dong-nan-fang-zhi-ye-xue-yuan.md
      - 广东培正学院: universities/yan-dong-pei-zheng-xue-yuan.md
      - 广东外语外贸大学: universities/yan-dong-wai-yu-wai-mao-da-xue.md
      - 广东外语外贸大学北校区: universities/yan-dong-wai-yu-wai-mao-da-xue-bei-xiao-qu.md
      - 广东外语外贸大学南国商学院: universities/yan-dong-wai-yu-wai-mao-da-xue-nan-guo-shang-xue-yuan.md
      - 广东外语外贸大学南校区: universities/yan-dong-wai-yu-wai-mao-da-xue-nan-xiao-qu.md
      - 广东外语外贸大学大学城校区: universities/yan-dong-wai-yu-wai-mao-da-xue-da-xue-cheng-xiao-qu.md
      - 广东外语外贸大学白云校区: universities/yan-dong-wai-yu-wai-mao-da-xue-bai-yun-xiao-qu.md
      - 广东工业大学: universities/yan-dong-gong-ye-da-xue.md
      - 广东工业大学东风路校区: universities/yan-dong-gong-ye-da-xue-dong-feng-lu-xiao-qu.md
      - 广东工业大学大学城校区: universities/yan-dong-gong-ye-da-xue-da-xue-cheng-xiao-qu.md
      - 广东工业大学揭阳校区: universities/yan-dong-gong-ye-da-xue-jie-yang-xiao-qu.md
      - 广东工业大学龙洞校区: universities/yan-dong-gong-ye-da-xue-long-dong-xiao-qu.md
      - 广东工商职业技术大学: universities/yan-dong-gong-shang-zhi-ye-ji-zhu-da-xue.md
      - 广东工程职业技术学院: universities/yan-dong-gong-cheng-zhi-ye-ji-zhu-xue-yuan.md
      - 广东工贸职业技术学院: universities/yan-dong-gong-mao-zhi-ye-ji-zhu-xue-yuan.md
      - 广东建设职业技术学院: universities/yan-dong-jian-she-zhi-ye-ji-zhu-xue-yuan.md
      - 广东技术师范大学: universities/yan-dong-ji-zhu-shi-fan-da-xue.md
      - 广东技术师范大学东校区: universities/yan-dong-ji-zhu-shi-fan-da-xue-dong-xiao-qu.md
      - 广东技术师范大学河源校区: universities/yan-dong-ji-zhu-shi-fan-da-xue-he-yuan-xiao-qu.md
      - 广东技术师范大学白云校区: universities/yan-dong-ji-zhu-shi-fan-da-xue-bai-yun-xiao-qu.md
      - 广东机电职业技术学院: universities/yan-dong-ji-dian-zhi-ye-ji-zhu-xue-yuan.md
      - 广东松山职业技术学院: universities/yan-dong-song-shan-zhi-ye-ji-zhu-xue-yuan.md
      - 广东松山职业技术学院广东信息职业技术学院曲江校区: universities/yan-dong-song-shan-zhi-ye-ji-zhu-xue-yuan-yan-dong-xin-xi-zhi-ye-ji-zhu-xue-yuan-qu-jiang-xiao-qu.md
      - 广东水利电力职业技术学院从化区: universities/yan-dong-shui-li-dian-li-zhi-ye-ji-zhu-xue-yuan-cong-hua-qu.md
      - 广东水利电力职业技术学院从化校区: universities/yan-dong-shui-li-dian-li-zhi-ye-ji-zhu-xue-yuan-cong-hua-xiao-qu.md
      - 广东江门幼儿师范高等专科学校: universities/yan-dong-jiang-men-you-er-shi-fan-gao-deng-zhuan-ke-xue-xiao.md
      - 广东海洋大学: universities/yan-dong-hai-yang-da-xue.md
      - 广东海洋大学湖光校区: universities/yan-dong-hai-yang-da-xue-hu-guang-xiao-qu.md
      - 广东海洋大学阳江校区: universities/yan-dong-hai-yang-da-xue-yang-jiang-xiao-qu.md
      - 广东理工学院: universities/yan-dong-li-gong-xue-yuan.md
      - 广东理工职业学院: universities/yan-dong-li-gong-zhi-ye-xue-yuan.md
      - 广东理工职业学院中山校区: universities/yan-dong-li-gong-zhi-ye-xue-yuan-zhong-shan-xiao-qu.md
      - 广东白云学院: universities/yan-dong-bai-yun-xue-yuan.md
      - 广东白云学院北校区: universities/yan-dong-bai-yun-xue-yuan-bei-xiao-qu.md
      - 广东白云学院西校区: universities/yan-dong-bai-yun-xue-yuan-xi-xiao-qu.md
      - 广东石油化工学院: universities/yan-dong-shi-you-hua-gong-xue-yuan.md
      - 广东科学技术职业学院: universities/yan-dong-ke-xue-ji-zhu-zhi-ye-xue-yuan.md
      - 广东科技学院: universities/yan-dong-ke-ji-xue-yuan.md
      - 广东科技学院松山湖校区: universities/yan-dong-ke-ji-xue-yuan-song-shan-hu-xiao-qu.md
      - 广东科贸职业学院: universities/yan-dong-ke-mao-zhi-ye-xue-yuan.md
      - 广东第二师范学院: universities/yan-dong-di-er-shi-fan-xue-yuan.md
      - 广东职业技术学院: universities/yan-dong-zhi-ye-ji-zhu-xue-yuan.md
      - 广东茂名健康职业学院: universities/yan-dong-mao-ming-jian-kang-zhi-ye-xue-yuan.md
      - 广东茂名农林科技职业学院: universities/yan-dong-mao-ming-nong-lin-ke-ji-zhi-ye-xue-yuan.md
      - 广东药科大学: universities/yan-dong-yao-ke-da-xue.md
      - 广东药科大学云浮校区: universities/yan-dong-yao-ke-da-xue-yun-fu-xiao-qu.md
      - 广东药科大学大学城校区: universities/yan-dong-yao-ke-da-xue-da-xue-cheng-xiao-qu.md
      - 广东财经大学: universities/yan-dong-cai-jing-da-xue.md
      - 广东轻工职业技术学院: universities/yan-dong-qing-gong-zhi-ye-ji-zhu-xue-yuan.md
      - 广东金融学院: universities/yan-dong-jin-rong-xue-yuan.md
      - 广东食品药品职业学院: universities/yan-dong-shi-pin-yao-pin-zhi-ye-xue-yuan.md
      - 广州东华职业学院: universities/yan-zhou-dong-hua-zhi-ye-xue-yuan.md
      - 广州中医药大学: universities/yan-zhou-zhong-yi-yao-da-xue.md
      - 广州中医药大学大学城校区: universities/yan-zhou-zhong-yi-yao-da-xue-da-xue-cheng-xiao-qu.md
      - 广州体育学院: universities/yan-zhou-ti-yu-xue-yuan.md
      - 广州医科大学: universities/yan-zhou-yi-ke-da-xue.md
      - 广州华商学院: universities/yan-zhou-hua-shang-xue-yuan.md
      - 广州华夏职业学院: universities/yan-zhou-hua-xia-zhi-ye-xue-yuan.md
      - 广州华立学院: universities/yan-zhou-hua-li-xue-yuan.md
      - 广州华立科技职业学院: universities/yan-zhou-hua-li-ke-ji-zhi-ye-xue-yuan.md
      - 广州南方学院: universities/yan-zhou-nan-fang-xue-yuan.md
      - 广州商学院: universities/yan-zhou-shang-xue-yuan.md
      - 广州城市理工学院: universities/yan-zhou-cheng-shi-li-gong-xue-yuan.md
      - 广州城市职业学院: universities/yan-zhou-cheng-shi-zhi-ye-xue-yuan.md
      - 广州城建职业学院: universities/yan-zhou-cheng-jian-zhi-ye-xue-yuan.md
      - 广州大学: universities/yan-zhou-da-xue.md
      - 广州工商学院: universities/yan-zhou-gong-shang-xue-yuan.md
      - 广州应用科技学院: universities/yan-zhou-ying-yong-ke-ji-xue-yuan.md
      - 广州新华学院: universities/yan-zhou-xin-hua-xue-yuan.md
      - 广州民航职业技术学院: universities/yan-zhou-min-hang-zhi-ye-ji-zhu-xue-yuan.md
      - 广州理工学院: universities/yan-zhou-li-gong-xue-yuan.md
      - 广州理工学院博罗校区: universities/yan-zhou-li-gong-xue-yuan-bo-luo-xiao-qu.md
      - 广州番禺职业技术学院: universities/yan-zhou-fan-yu-zhi-ye-ji-zhu-xue-yuan.md
      - 广州科技职业技术大学: universities/yan-zhou-ke-ji-zhi-ye-ji-zhu-da-xue.md
      - 广州美术学院: universities/yan-zhou-mei-shu-xue-yuan.md
      - 广州航海学院: universities/yan-zhou-hang-hai-xue-yuan.md
      - 广州软件学院: universities/yan-zhou-ruan-jian-xue-yuan.md
      - 广州铁路职业技术学院: universities/yan-zhou-tie-lu-zhi-ye-ji-zhu-xue-yuan.md
      - 惠州学院: universities/hui-zhou-xue-yuan.md
      - 惠州工程职业学院: universities/hui-zhou-gong-cheng-zhi-ye-xue-yuan.md
      - 惠州经济职业技术学院: universities/hui-zhou-jing-ji-zhi-ye-ji-zhu-xue-yuan.md
      - 暨南大学: universities/ji-nan-da-xue.md
      - 暨南大学珠海校区: universities/ji-nan-da-xue-zhu-hai-xiao-qu.md
      - 暨南大学番禺校区: universities/ji-nan-da-xue-fan-yu-xiao-qu.md
      - 汕头大学: universities/shan-tou-da-xue.md
      - 汕头职业技术学院: universities/shan-tou-zhi-ye-ji-zhu-xue-yuan.md
      - 江门职业技术学院: universities/jiang-men-zhi-ye-ji-zhu-xue-yuan.md
      - 深圳信息职业技术学院: universities/shen-zhen-xin-xi-zhi-ye-ji-zhu-xue-yuan.md
      - 深圳北理莫斯科大学: universities/shen-zhen-bei-li-mo-si-ke-da-xue.md
      - 深圳大学: universities/shen-zhen-da-xue.md
      - 深圳大学丽湖校区: universities/shen-zhen-da-xue-li-hu-xiao-qu.md
      - 深圳技术大学: universities/shen-zhen-ji-zhu-da-xue.md
      - 深圳职业技术大学: universities/shen-zhen-zhi-ye-ji-zhu-da-xue.md
      - 清远职业技术学院: universities/qing-yuan-zhi-ye-ji-zhu-xue-yuan.md
      - 湛江科技学院: universities/zhan-jiang-ke-ji-xue-yuan.md
      - 潮汕职业技术学院: universities/chao-shan-zhi-ye-ji-zhu-xue-yuan.md
      - 珠海科技学院: universities/zhu-hai-ke-ji-xue-yuan.md
      - 电子科技大学中山学院: universities/dian-zi-ke-ji-da-xue-zhong-shan-xue-yuan.md
      - 罗定职业技术学院: universities/luo-ding-zhi-ye-ji-zhu-xue-yuan.md
      - 肇庆医学高等专科学校: universities/zhao-qing-yi-xue-gao-deng-zhuan-ke-xue-xiao.md
      - 肇庆学院: universities/zhao-qing-xue-yuan.md
      - 茂名职业技术学院: universities/mao-ming-zhi-ye-ji-zhu-xue-yuan.md
      - 韩山师范学院: universities/han-shan-shi-fan-xue-yuan.md
      - 韶关学院: universities/shao-guan-xue-yuan.md
      - 顺德职业技术学院: universities/shun-de-zhi-ye-ji-zhu-xue-yuan.md
      - 香港中文大学深圳: universities/xiang-gang-zhong-wen-da-xue-shen-zhen.md
    - 广西:
      - 北海艺术设计学院: universities/bei-hai-yi-zhu-she-ji-xue-yuan.md
      - 北部湾大学: universities/bei-bu-wan-da-xue.md
      - 南宁学院: universities/nan-zhu-xue-yuan.md
      - 南宁师范大学: universities/nan-zhu-shi-fan-da-xue.md
      - 南宁师范大学师园学院: universities/nan-zhu-shi-fan-da-xue-shi-yuan-xue-yuan.md
      - 南宁理工学院: universities/nan-zhu-li-gong-xue-yuan.md
      - 南宁职业技术学院: universities/nan-zhu-zhi-ye-ji-zhu-xue-yuan.md
      - 右江民族医学院: universities/you-jiang-min-zu-yi-xue-yuan.md
      - 广西中医药大学仙葫校区: universities/yan-xi-zhong-yi-yao-da-xue-xian-hu-xiao-qu.md
      - 广西中医药大学赛恩斯新医药学院: universities/yan-xi-zhong-yi-yao-da-xue-sai-en-si-xin-yi-yao-xue-yuan.md
      - 广西交通职业技术学院: universities/yan-xi-jiao-tong-zhi-ye-ji-zhu-xue-yuan.md
      - 广西体育高等专科学校: universities/yan-xi-ti-yu-gao-deng-zhuan-ke-xue-xiao.md
      - 广西体育高等专科学校长岗校区: universities/yan-xi-ti-yu-gao-deng-zhuan-ke-xue-xiao-chang-gang-xiao-qu.md
      - 广西农业职业技术大学: universities/yan-xi-nong-ye-zhi-ye-ji-zhu-da-xue.md
      - 广西制造工程职业技术学院: universities/yan-xi-zhi-zao-gong-cheng-zhi-ye-ji-zhu-xue-yuan.md
      - 广西北部湾大学: universities/yan-xi-bei-bu-wan-da-xue.md
      - 广西医科大学: universities/yan-xi-yi-ke-da-xue.md
      - 广西医科大学双拥路校本部: universities/yan-xi-yi-ke-da-xue-shuang-yong-lu-xiao-ben-bu.md
      - 广西医科大学武鸣校区: universities/yan-xi-yi-ke-da-xue-wu-ming-xiao-qu.md
      - 广西城市职业大学: universities/yan-xi-cheng-shi-zhi-ye-da-xue.md
      - 广西外国语学院: universities/yan-xi-wai-guo-yu-xue-yuan.md
      - 广西外国语学院空港校区: universities/yan-xi-wai-guo-yu-xue-yuan-kong-gang-xiao-qu.md
      - 广西大学: universities/yan-xi-da-xue.md
      - 广西大学行健文理学院: universities/yan-xi-da-xue-xing-jian-wen-li-xue-yuan.md
      - 广西工业职业技术学院: universities/yan-xi-gong-ye-zhi-ye-ji-zhu-xue-yuan.md
      - 广西工业职业技术学院武鸣校区: universities/yan-xi-gong-ye-zhi-ye-ji-zhu-xue-yuan-wu-ming-xiao-qu.md
      - 广西师范大学: universities/yan-xi-shi-fan-da-xue.md
      - 广西师范大学雁山校区: universities/yan-xi-shi-fan-da-xue-yan-shan-xiao-qu.md
      - 广西建设职业技术学院: universities/yan-xi-jian-she-zhi-ye-ji-zhu-xue-yuan.md
      - 广西机电职业技术学院: universities/yan-xi-ji-dian-zhi-ye-ji-zhu-xue-yuan.md
      - 广西民族大学: universities/yan-xi-min-zu-da-xue.md
      - 广西民族大学相思湖学院: universities/yan-xi-min-zu-da-xue-xiang-si-hu-xue-yuan.md
      - 广西民族师范学院: universities/yan-xi-min-zu-shi-fan-xue-yuan.md
      - 广西水利电力职业技术学院: universities/yan-xi-shui-li-dian-li-zhi-ye-ji-zhu-xue-yuan.md
      - 广西演艺职业学院: universities/yan-xi-yan-yi-zhi-ye-xue-yuan.md
      - 广西科技大学: universities/yan-xi-ke-ji-da-xue.md
      - 广西科技大学柳石校区: universities/yan-xi-ke-ji-da-xue-liu-shi-xiao-qu.md
      - 广西科技师范学院: universities/yan-xi-ke-ji-shi-fan-xue-yuan.md
      - 广西职业师范学院: universities/yan-xi-zhi-ye-shi-fan-xue-yuan.md
      - 广西艺术学院: universities/yan-xi-yi-zhu-xue-yuan.md
      - 广西警察学院: universities/yan-xi-jing-cha-xue-yuan.md
      - 广西财经学院: universities/yan-xi-cai-jing-xue-yuan.md
      - 柳州工学院: universities/liu-zhou-gong-xue-yuan.md
      - 柳州职业技术学院: universities/liu-zhou-zhi-ye-ji-zhu-xue-yuan.md
      - 柳州职业技术学院官塘校区: universities/liu-zhou-zhi-ye-ji-zhu-xue-yuan-guan-tang-xiao-qu.md
      - 桂林信息科技学院: universities/gui-lin-xin-xi-ke-ji-xue-yuan.md
      - 桂林医学院: universities/gui-lin-yi-xue-yuan.md
      - 桂林师范高等专科学校: universities/gui-lin-shi-fan-gao-deng-zhuan-ke-xue-xiao.md
      - 桂林旅游学院: universities/gui-lin-lu-you-xue-yuan.md
      - 桂林理工大学: universities/gui-lin-li-gong-da-xue.md
      - 桂林理工大学南宁分校: universities/gui-lin-li-gong-da-xue-nan-zhu-fen-xiao.md
      - 桂林电子科技大学: universities/gui-lin-dian-zi-ke-ji-da-xue.md
      - 桂林电子科技大学北海校区: universities/gui-lin-dian-zi-ke-ji-da-xue-bei-hai-xiao-qu.md
      - 桂林电子科技大学北海校区/广西海洋学院即将转设的新名字: universities/gui-lin-dian-zi-ke-ji-da-xue-bei-hai-xiao-qu-yan-xi-hai-yang-xue-yuan-ji-jiang-zhuan-she-de-xin-ming-zi.md
      - 桂林电子科技大学花江校区: universities/gui-lin-dian-zi-ke-ji-da-xue-hua-jiang-xiao-qu.md
      - 桂林航天工业学院: universities/gui-lin-hang-tian-gong-ye-xue-yuan.md
      - 梧州医学高等专科学校: universities/wu-zhou-yi-xue-gao-deng-zhuan-ke-xue-xiao.md
      - 梧州学院: universities/wu-zhou-xue-yuan.md
      - 河池学院: universities/he-chi-xue-yuan.md
      - 玉林师范学院: universities/yu-lin-shi-fan-xue-yuan.md
      - 百色学院: universities/bai-se-xue-yuan.md
      - 百色学院东合校区: universities/bai-se-xue-yuan-dong-he-xiao-qu.md
      - 贺州学院: universities/he-zhou-xue-yuan.md
      - 钦州幼儿师范高等专科学校: universities/qin-zhou-you-er-shi-fan-gao-deng-zhuan-ke-xue-xiao.md
    - 海南:
      - 三亚学院: universities/san-ya-xue-yuan.md
      - 三亚航空旅游职业学院: universities/san-ya-hang-kong-lu-you-zhi-ye-xue-yuan.md
      - 海南健康管理职业技术学院澄迈校区: universities/hai-nan-jian-kang-guan-li-zhi-ye-ji-zhu-xue-yuan-cheng-mai-xiao-qu.md
      - 海南医学院: universities/hai-nan-yi-xue-yuan.md
      - 海南外国语职业学院: universities/hai-nan-wai-guo-yu-zhi-ye-xue-yuan.md
      - 海南大学: universities/hai-nan-da-xue.md
      - 海南大学儋州校区: universities/hai-nan-da-xue-dan-zhou-xiao-qu.md
      - 海南大学海甸校区: universities/hai-nan-da-xue-hai-dian-xiao-qu.md
      - 海南师范大学: universities/hai-nan-shi-fan-da-xue.md
      - 海南热带海洋学院: universities/hai-nan-re-dai-hai-yang-xue-yuan.md
      - 海南科技职业大学: universities/hai-nan-ke-ji-zhi-ye-da-xue.md
      - 海南经贸职业技术学院: universities/hai-nan-jing-mao-zhi-ye-ji-zhu-xue-yuan.md
      - 海南职业技术学院: universities/hai-nan-zhi-ye-ji-zhu-xue-yuan.md
      - 海南软件职业技术学院: universities/hai-nan-ruan-jian-zhi-ye-ji-zhu-xue-yuan.md
      - 海口经济学院: universities/hai-kou-jing-ji-xue-yuan.md
    - 重庆:
      - 中国人民解放军陆军军医大学: universities/zhong-guo-ren-min-jie-fang-jun-lu-jun-jun-yi-da-xue.md
      - 四川外国语大学: universities/si-chuan-wai-guo-yu-da-xue.md
      - 四川美术学院: universities/si-chuan-mei-shu-xue-yuan.md
      - 西南大学: universities/xi-nan-da-xue.md
      - 西南大学荣昌校区: universities/xi-nan-da-xue-rong-chang-xiao-qu.md
      - 西南政法大学: universities/xi-nan-zheng-fa-da-xue.md
      - 重庆三峡医药高等专科学校: universities/zhong-qing-san-xia-yi-yao-gao-deng-zhuan-ke-xue-xiao.md
      - 重庆三峡学院: universities/zhong-qing-san-xia-xue-yuan.md
      - 重庆交通大学: universities/zhong-qing-jiao-tong-da-xue.md
      - 重庆交通大学科学城校区: universities/zhong-qing-jiao-tong-da-xue-ke-xue-cheng-xiao-qu.md
      - 重庆人文科技学院: universities/zhong-qing-ren-wen-ke-ji-xue-yuan.md
      - 重庆公共运输职业学院: universities/zhong-qing-gong-gong-yun-shu-zhi-ye-xue-yuan.md
      - 重庆医科大学: universities/zhong-qing-yi-ke-da-xue.md
      - 重庆医药高等专科学校: universities/zhong-qing-yi-yao-gao-deng-zhuan-ke-xue-xiao.md
      - 重庆城市科技学院: universities/zhong-qing-cheng-shi-ke-ji-xue-yuan.md
      - 重庆城市管理职业学院: universities/zhong-qing-cheng-shi-guan-li-zhi-ye-xue-yuan.md
      - 重庆外语外事学院: universities/zhong-qing-wai-yu-wai-shi-xue-yuan.md
      - 重庆大学: universities/zhong-qing-da-xue.md
      - 重庆大学两江校区: universities/zhong-qing-da-xue-liang-jiang-xiao-qu.md
      - 重庆大学虎溪校区: universities/zhong-qing-da-xue-hu-xi-xiao-qu.md
      - 重庆工商大学: universities/zhong-qing-gong-shang-da-xue.md
      - 重庆工商大学派斯学院: universities/zhong-qing-gong-shang-da-xue-pai-si-xue-yuan.md
      - 重庆工商职业学院: universities/zhong-qing-gong-shang-zhi-ye-xue-yuan.md
      - 重庆工程学院: universities/zhong-qing-gong-cheng-xue-yuan.md
      - 重庆工程职业技术学院: universities/zhong-qing-gong-cheng-zhi-ye-ji-zhu-xue-yuan.md
      - 重庆工贸职业技术学院: universities/zhong-qing-gong-mao-zhi-ye-ji-zhu-xue-yuan.md
      - 重庆师范大学: universities/zhong-qing-shi-fan-da-xue.md
      - 重庆文化艺术职业学院: universities/zhong-qing-wen-hua-yi-zhu-zhi-ye-xue-yuan.md
      - 重庆文理学院: universities/zhong-qing-wen-li-xue-yuan.md
      - 重庆旅游职业学院: universities/zhong-qing-lu-you-zhi-ye-xue-yuan.md
      - 重庆智能工程职业学院: universities/zhong-qing-zhi-neng-gong-cheng-zhi-ye-xue-yuan.md
      - 重庆理工大学: universities/zhong-qing-li-gong-da-xue.md
      - 重庆理工职业学院: universities/zhong-qing-li-gong-zhi-ye-xue-yuan.md
      - 重庆电力高等专科学校: universities/zhong-qing-dian-li-gao-deng-zhuan-ke-xue-xiao.md
      - 重庆电子工程职业学院: universities/zhong-qing-dian-zi-gong-cheng-zhi-ye-xue-yuan.md
      - 重庆科技学院: universities/zhong-qing-ke-ji-xue-yuan.md
      - 重庆第二师范学院: universities/zhong-qing-di-er-shi-fan-xue-yuan.md
      - 重庆能源职业学院: universities/zhong-qing-neng-yuan-zhi-ye-xue-yuan.md
      - 重庆艺术工程职业学院: universities/zhong-qing-yi-zhu-gong-cheng-zhi-ye-xue-yuan.md
      - 重庆警察学院: universities/zhong-qing-jing-cha-xue-yuan.md
      - 重庆财经学院: universities/zhong-qing-cai-jing-xue-yuan.md
      - 重庆财经职业学院: universities/zhong-qing-cai-jing-zhi-ye-xue-yuan.md
      - 重庆邮电大学: universities/zhong-qing-you-dian-da-xue.md
      - 长江师范学院: universities/chang-jiang-shi-fan-xue-yuan.md
    - 四川:
      - 中国民用航空飞行学院: universities/zhong-guo-min-yong-hang-kong-fei-xing-xue-yuan.md
      - 乐山师范学院: universities/le-shan-shi-fan-xue-yuan.md
      - 乐山职业技术学院: universities/le-shan-zhi-ye-ji-zhu-xue-yuan.md
      - 内江卫生与健康职业学院: universities/nei-jiang-wei-sheng-yu-jian-kang-zhi-ye-xue-yuan.md
      - 内江师范学院: universities/nei-jiang-shi-fan-xue-yuan.md
      - 南充文化旅游职业学院: universities/nan-chong-wen-hua-lu-you-zhi-ye-xue-yuan.md
      - 南充职业技术学院: universities/nan-chong-zhi-ye-ji-zhu-xue-yuan.md
      - 吉利学院: universities/ji-li-xue-yuan.md
      - 四川中医药高等专科学校: universities/si-chuan-zhong-yi-yao-gao-deng-zhuan-ke-xue-xiao.md
      - 四川交通职业技术学院: universities/si-chuan-jiao-tong-zhi-ye-ji-zhu-xue-yuan.md
      - 四川传媒学院: universities/si-chuan-chuan-mei-xue-yuan.md
      - 四川信息职业技术学院: universities/si-chuan-xin-xi-zhi-ye-ji-zhu-xue-yuan.md
      - 四川农业大学: universities/si-chuan-nong-ye-da-xue.md
      - 四川农业大学都江堰校区: universities/si-chuan-nong-ye-da-xue-du-jiang-yan-xiao-qu.md
      - 四川农业大学雅安校区: universities/si-chuan-nong-ye-da-xue-ya-an-xiao-qu.md
      - 四川化工职业技术学院: universities/si-chuan-hua-gong-zhi-ye-ji-zhu-xue-yuan.md
      - 四川卫生康复职业学院: universities/si-chuan-wei-sheng-kang-fu-zhi-ye-xue-yuan.md
      - 四川外国语大学成都学院: universities/si-chuan-wai-guo-yu-da-xue-cheng-du-xue-yuan.md
      - 四川大学: universities/si-chuan-da-xue.md
      - 四川大学锦城学院: universities/si-chuan-da-xue-jin-cheng-xue-yuan.md
      - 四川大学锦江学院: universities/si-chuan-da-xue-jin-jiang-xue-yuan.md
      - 四川工业科技学院: universities/si-chuan-gong-ye-ke-ji-xue-yuan.md
      - 四川工商职业技术学院: universities/si-chuan-gong-shang-zhi-ye-ji-zhu-xue-yuan.md
      - 四川师范大学: universities/si-chuan-shi-fan-da-xue.md
      - 四川幼儿师范高等专科学校: universities/si-chuan-you-er-shi-fan-gao-deng-zhuan-ke-xue-xiao.md
      - 四川建筑职业技术学院德阳校区: universities/si-chuan-jian-zhu-zhi-ye-ji-zhu-xue-yuan-de-yang-xiao-qu.md
      - 四川护理职业学院成都校区: universities/si-chuan-hu-li-zhi-ye-xue-yuan-cheng-du-xiao-qu.md
      - 四川文化产业职业学院: universities/si-chuan-wen-hua-chan-ye-zhi-ye-xue-yuan.md
      - 四川文化艺术学院: universities/si-chuan-wen-hua-yi-zhu-xue-yuan.md
      - 四川文轩职业学院: universities/si-chuan-wen-xuan-zhi-ye-xue-yuan.md
      - 四川民族学院: universities/si-chuan-min-zu-xue-yuan.md
      - 四川电影电视学院: universities/si-chuan-dian-ying-dian-shi-xue-yuan.md
      - 四川科技职业学院: universities/si-chuan-ke-ji-zhi-ye-xue-yuan.md
      - 四川职业技术学院: universities/si-chuan-zhi-ye-ji-zhu-xue-yuan.md
      - 四川西南航空职业学院: universities/si-chuan-xi-nan-hang-kong-zhi-ye-xue-yuan.md
      - 四川警察学院: universities/si-chuan-jing-cha-xue-yuan.md
      - 四川轻化工大学: universities/si-chuan-qing-hua-gong-da-xue.md
      - 四川邮电职业技术学院: universities/si-chuan-you-dian-zhi-ye-ji-zhu-xue-yuan.md
      - 四川音乐学院: universities/si-chuan-yin-le-xue-yuan.md
      - 宜宾学院: universities/yi-bin-xue-yuan.md
      - 川北医学院: universities/chuan-bei-yi-xue-yuan.md
      - 巴中职业技术学院: universities/ba-zhong-zhi-ye-ji-zhu-xue-yuan.md
      - 成都东软学院: universities/cheng-du-dong-ruan-xue-yuan.md
      - 成都中医药大学: universities/cheng-du-zhong-yi-yao-da-xue.md
      - 成都中医药大学温江校区: universities/cheng-du-zhong-yi-yao-da-xue-wen-jiang-xiao-qu.md
      - 成都体育学院: universities/cheng-du-ti-yu-xue-yuan.md
      - 成都体育学院武侯校区: universities/cheng-du-ti-yu-xue-yuan-wu-hou-xiao-qu.md
      - 成都信息工程大学: universities/cheng-du-xin-xi-gong-cheng-da-xue.md
      - 成都信息工程大学航空港校区: universities/cheng-du-xin-xi-gong-cheng-da-xue-hang-kong-gang-xiao-qu.md
      - 成都医学院: universities/cheng-du-yi-xue-yuan.md
      - 成都大学: universities/cheng-du-da-xue.md
      - 成都工业学院宜宾校区: universities/cheng-du-gong-ye-xue-yuan-yi-bin-xiao-qu.md
      - 成都工业职业技术学院: universities/cheng-du-gong-ye-zhi-ye-ji-zhu-xue-yuan.md
      - 成都师范学院: universities/cheng-du-shi-fan-xue-yuan.md
      - 成都文理学院: universities/cheng-du-wen-li-xue-yuan.md
      - 成都理工大学: universities/cheng-du-li-gong-da-xue.md
      - 成都理工大学宜宾校区: universities/cheng-du-li-gong-da-xue-yi-bin-xiao-qu.md
      - 成都理工大学工程技术学院: universities/cheng-du-li-gong-da-xue-gong-cheng-ji-zhu-xue-yuan.md
      - 成都航空职业技术学院: universities/cheng-du-hang-kong-zhi-ye-ji-zhu-xue-yuan.md
      - 成都艺术职业大学: universities/cheng-du-yi-zhu-zhi-ye-da-xue.md
      - 成都银杏酒店管理学院: universities/cheng-du-yin-xing-jiu-dian-guan-li-xue-yuan.md
      - 成都锦城学院: universities/cheng-du-jin-cheng-xue-yuan.md
      - 攀枝花学院: universities/pan-zhi-hua-xue-yuan.md
      - 民办四川天一学院: universities/min-ban-si-chuan-tian-yi-xue-yuan.md
      - 电子科技大学: universities/dian-zi-ke-ji-da-xue.md
      - 电子科技大学成都学院: universities/dian-zi-ke-ji-da-xue-cheng-du-xue-yuan.md
      - 电子科技大学沙河校区: universities/dian-zi-ke-ji-da-xue-sha-he-xiao-qu.md
      - 电子科技大学清水河校区: universities/dian-zi-ke-ji-da-xue-qing-shui-he-xiao-qu.md
      - 眉山职业技术学院: universities/mei-shan-zhi-ye-ji-zhu-xue-yuan.md
      - 眉山药科职业学院: universities/mei-shan-yao-ke-zhi-ye-xue-yuan.md
      - 绵阳城市学院: universities/mian-yang-cheng-shi-xue-yuan.md
      - 绵阳师范学院: universities/mian-yang-shi-fan-xue-yuan.md
      - 绵阳职业技术学院: universities/mian-yang-zhi-ye-ji-zhu-xue-yuan.md
      - 绵阳飞行职业学院: universities/mian-yang-fei-xing-zhi-ye-xue-yuan.md
      - 西华大学: universities/xi-hua-da-xue.md
      - 西华师范大学: universities/xi-hua-shi-fan-da-xue.md
      - 西南交通大学: universities/xi-nan-jiao-tong-da-xue.md
      - 西南医科大学: universities/xi-nan-yi-ke-da-xue.md
      - 西南民族大学: universities/xi-nan-min-zu-da-xue.md
      - 西南石油大学: universities/xi-nan-shi-you-da-xue.md
      - 西南科技大学: universities/xi-nan-ke-ji-da-xue.md
      - 西南财经大学: universities/xi-nan-cai-jing-da-xue.md
      - 西昌学院北校区: universities/xi-chang-xue-yuan-bei-xiao-qu.md
      - 阿坝师范学院: universities/a-ba-shi-fan-xue-yuan.md
    - 贵州:
      - 六盘水师范学院: universities/liu-pan-shui-shi-fan-xue-yuan.md
      - 凯里学院: universities/kai-li-xue-yuan.md
      - 贵州中医药大学: universities/gui-zhou-zhong-yi-yao-da-xue.md
      - 贵州中医药大学时珍学院: universities/gui-zhou-zhong-yi-yao-da-xue-shi-zhen-xue-yuan.md
      - 贵州中医药大学花溪校区: universities/gui-zhou-zhong-yi-yao-da-xue-hua-xi-xiao-qu.md
      - 贵州医科大学: universities/gui-zhou-yi-ke-da-xue.md
      - 贵州商学院: universities/gui-zhou-shang-xue-yuan.md
      - 贵州大学: universities/gui-zhou-da-xue.md
      - 贵州师范大学: universities/gui-zhou-shi-fan-da-xue.md
      - 贵州师范学院: universities/gui-zhou-shi-fan-xue-yuan.md
      - 贵州民族大学: universities/gui-zhou-min-zu-da-xue.md
      - 贵州理工学院: universities/gui-zhou-li-gong-xue-yuan.md
      - 贵州电子商务职业技术学院: universities/gui-zhou-dian-zi-shang-wu-zhi-ye-ji-zhu-xue-yuan.md
      - 贵州盛华职业学院: universities/gui-zhou-sheng-hua-zhi-ye-xue-yuan.md
      - 贵州经贸职业技术学院: universities/gui-zhou-jing-mao-zhi-ye-ji-zhu-xue-yuan.md
      - 贵州警察学院: universities/gui-zhou-jing-cha-xue-yuan.md
      - 贵阳人文科技学院: universities/gui-yang-ren-wen-ke-ji-xue-yuan.md
      - 贵阳学院: universities/gui-yang-xue-yuan.md
      - 贵阳职业技术学院: universities/gui-yang-zhi-ye-ji-zhu-xue-yuan.md
      - 遵义医科大学: universities/zun-yi-yi-ke-da-xue.md
      - 遵义医科大学珠海校区: universities/zun-yi-yi-ke-da-xue-zhu-hai-xiao-qu.md
      - 遵义师范学院: universities/zun-yi-shi-fan-xue-yuan.md
      - 遵义职业技术学院: universities/zun-yi-zhi-ye-ji-zhu-xue-yuan.md
      - 铜仁学院: universities/tong-ren-xue-yuan.md
      - 黔南民族医学高等专科学校: universities/qian-nan-min-zu-yi-xue-gao-deng-zhuan-ke-xue-xiao.md
      - 黔南民族师范学院: universities/qian-nan-min-zu-shi-fan-xue-yuan.md
    - 云南:
      - 丽江师范高等专科学校: universities/li-jiang-shi-fan-gao-deng-zhuan-ke-xue-xiao.md
      - 丽江文化旅游学院: universities/li-jiang-wen-hua-lu-you-xue-yuan.md
      - 云南中医药大学: universities/yun-nan-zhong-yi-yao-da-xue.md
      - 云南交通职业技术学院: universities/yun-nan-jiao-tong-zhi-ye-ji-zhu-xue-yuan.md
      - 云南农业大学: universities/yun-nan-nong-ye-da-xue.md
      - 云南大学: universities/yun-nan-da-xue.md
      - 云南大学东陆校区: universities/yun-nan-da-xue-dong-lu-xiao-qu.md
      - 云南大学滇池学院: universities/yun-nan-da-xue-dian-chi-xue-yuan.md
      - 云南大学滇池学院杨林: universities/yun-nan-da-xue-dian-chi-xue-yuan-yang-lin.md
      - 云南师范大学: universities/yun-nan-shi-fan-da-xue.md
      - 云南旅游职业学院: universities/yun-nan-lu-you-zhi-ye-xue-yuan.md
      - 云南林业职业技术学院: universities/yun-nan-lin-ye-zhi-ye-ji-zhu-xue-yuan.md
      - 云南民族大学: universities/yun-nan-min-zu-da-xue.md
      - 云南经济管理学院: universities/yun-nan-jing-ji-guan-li-xue-yuan.md
      - 云南艺术学院: universities/yun-nan-yi-zhu-xue-yuan.md
      - 云南财经大学: universities/yun-nan-cai-jing-da-xue.md
      - 云南财经大学龙泉校区: universities/yun-nan-cai-jing-da-xue-long-quan-xiao-qu.md
      - 大理大学: universities/da-li-da-xue.md
      - 文山学院: universities/wen-shan-xue-yuan.md
      - 昆明冶金高等专科学校: universities/kun-ming-ye-jin-gao-deng-zhuan-ke-xue-xiao.md
      - 昆明医科大学: universities/kun-ming-yi-ke-da-xue.md
      - 昆明城市学院: universities/kun-ming-cheng-shi-xue-yuan.md
      - 昆明学院: universities/kun-ming-xue-yuan.md
      - 昆明理工大学: universities/kun-ming-li-gong-da-xue.md
      - 昭通学院: universities/zhao-tong-xue-yuan.md
      - 普洱学院: universities/pu-er-xue-yuan.md
      - 楚雄医药高等专科学校: universities/chu-xiong-yi-yao-gao-deng-zhuan-ke-xue-xiao.md
      - 楚雄师范学院: universities/chu-xiong-shi-fan-xue-yuan.md
      - 滇西应用技术大学本部校区: universities/dian-xi-ying-yong-ji-zhu-da-xue-ben-bu-xiao-qu.md
      - 滇西科技师范学院: universities/dian-xi-ke-ji-shi-fan-xue-yuan.md
      - 玉溪师范学院: universities/yu-xi-shi-fan-xue-yuan.md
      - 红河卫生职业学院: universities/hong-he-wei-sheng-zhi-ye-xue-yuan.md
      - 红河学院: universities/hong-he-xue-yuan.md
    - 西藏:
      - 拉萨师范高等专科学校: universities/la-sa-shi-fan-gao-deng-zhuan-ke-xue-xiao.md
      - 西藏农牧学院: universities/xi-cang-nong-mu-xue-yuan.md
      - 西藏大学: universities/xi-cang-da-xue.md
      - 西藏民族大学: universities/xi-cang-min-zu-da-xue.md
      - 西藏职业技术学院: universities/xi-cang-zhi-ye-ji-zhu-xue-yuan.md
    - 陕西:
      - 中国人民解放军空军军医大学: universities/zhong-guo-ren-min-jie-fang-jun-kong-jun-jun-yi-da-xue.md
      - 咸阳师范学院: universities/xian-yang-shi-fan-xue-yuan.md
      - 咸阳师范学院秦都书院: universities/xian-yang-shi-fan-xue-yuan-qin-du-shu-yuan.md
      - 咸阳职业技术学院: universities/xian-yang-zhi-ye-ji-zhu-xue-yuan.md
      - 商洛学院: universities/shang-luo-xue-yuan.md
      - 安康学院: universities/an-kang-xue-yuan.md
      - 宝鸡文理学院: universities/bao-ji-wen-li-xue-yuan.md
      - 宝鸡文理学院老校区: universities/bao-ji-wen-li-xue-yuan-lao-xiao-qu.md
      - 宝鸡职业技术学院: universities/bao-ji-zhi-ye-ji-zhu-xue-yuan.md
      - 延安大学: universities/yan-an-da-xue.md
      - 杨凌职业技术学院: universities/yang-ling-zhi-ye-ji-zhu-xue-yuan.md
      - 榆林学院: universities/yu-lin-xue-yuan.md
      - 汉中职业技术学院: universities/yi-zhong-zhi-ye-ji-zhu-xue-yuan.md
      - 渭南师范学院: universities/wei-nan-shi-fan-xue-yuan.md
      - 空军军医大学: universities/kong-jun-jun-yi-da-xue.md
      - 西京学院: universities/xi-jing-xue-yuan.md
      - 西北农林科技大学: universities/xi-bei-nong-lin-ke-ji-da-xue.md
      - 西北大学: universities/xi-bei-da-xue.md
      - 西北大学现代学院: universities/xi-bei-da-xue-xian-dai-xue-yuan.md
      - 西北工业大学: universities/xi-bei-gong-ye-da-xue.md
      - 西北工业大学长安校区: universities/xi-bei-gong-ye-da-xue-chang-an-xiao-qu.md
      - 西北政法大学: universities/xi-bei-zheng-fa-da-xue.md
      - 西安交通大学: universities/xi-an-jiao-tong-da-xue.md
      - 西安交通大学创新港校区: universities/xi-an-jiao-tong-da-xue-chuang-xin-gang-xiao-qu.md
      - 西安交通工程学院: universities/xi-an-jiao-tong-gong-cheng-xue-yuan.md
      - 西安体育学院: universities/xi-an-ti-yu-xue-yuan.md
      - 西安信息职业大学: universities/xi-an-xin-xi-zhi-ye-da-xue.md
      - 西安医学院: universities/xi-an-yi-xue-yuan.md
      - 西安外国语大学: universities/xi-an-wai-guo-yu-da-xue.md
      - 西安工业大学: universities/xi-an-gong-ye-da-xue.md
      - 西安工商学院: universities/xi-an-gong-shang-xue-yuan.md
      - 西安工程大学: universities/xi-an-gong-cheng-da-xue.md
      - 西安工程大学临潼校区: universities/xi-an-gong-cheng-da-xue-lin-tong-xiao-qu.md
      - 西安建筑科技大学: universities/xi-an-jian-zhu-ke-ji-da-xue.md
      - 西安建筑科技大学草堂校区: universities/xi-an-jian-zhu-ke-ji-da-xue-cao-tang-xiao-qu.md
      - 西安思源学院: universities/xi-an-si-yuan-xue-yuan.md
      - 西安文理学院: universities/xi-an-wen-li-xue-yuan.md
      - 西安明德理工学院: universities/xi-an-ming-de-li-gong-xue-yuan.md
      - 西安欧亚学院: universities/xi-an-ou-ya-xue-yuan.md
      - 西安理工大学: universities/xi-an-li-gong-da-xue.md
      - 西安理工大学高科学院: universities/xi-an-li-gong-da-xue-gao-ke-xue-yuan.md
      - 西安电子科技大学: universities/xi-an-dian-zi-ke-ji-da-xue.md
      - 西安石油大学: universities/xi-an-shi-you-da-xue.md
      - 西安石油大学鄠邑校区: universities/xi-an-shi-you-da-xue-hu-yi-xiao-qu.md
      - 西安科技大学: universities/xi-an-ke-ji-da-xue.md
      - 西安科技大学高新学院: universities/xi-an-ke-ji-da-xue-gao-xin-xue-yuan.md
      - 西安美术学院: universities/xi-an-mei-shu-xue-yuan.md
      - 西安翻译学院: universities/xi-an-fan-yi-xue-yuan.md
      - 西安航空学院: universities/xi-an-hang-kong-xue-yuan.md
      - 西安航空职业技术学院: universities/xi-an-hang-kong-zhi-ye-ji-zhu-xue-yuan.md
      - 西安财经大学: universities/xi-an-cai-jing-da-xue.md
      - 西安邮电大学: universities/xi-an-you-dian-da-xue.md
      - 西安铁路职业技术学院: universities/xi-an-tie-lu-zhi-ye-ji-zhu-xue-yuan.md
      - 长安大学: universities/chang-an-da-xue.md
      - 陕西中医药大学: universities/shan-xi-zhong-yi-yao-da-xue.md
      - 陕西国际商贸学院: universities/shan-xi-guo-ji-shang-mao-xue-yuan.md
      - 陕西学前师范学院: universities/shan-xi-xue-qian-shi-fan-xue-yuan.md
      - 陕西工业职业技术学院: universities/shan-xi-gong-ye-zhi-ye-ji-zhu-xue-yuan.md
      - 陕西工商职业学院: universities/shan-xi-gong-shang-zhi-ye-xue-yuan.md
      - 陕西师范大学: universities/shan-xi-shi-fan-da-xue.md
      - 陕西理工大学: universities/shan-xi-li-gong-da-xue.md
      - 陕西科技大学: universities/shan-xi-ke-ji-da-xue.md
      - 陕西科技大学镐京学院: universities/shan-xi-ke-ji-da-xue-hao-jing-xue-yuan.md
      - 陕西职业技术学院: universities/shan-xi-zhi-ye-ji-zhu-xue-yuan.md
      - 陕西财经职业技术学院: universities/shan-xi-cai-jing-zhi-ye-ji-zhu-xue-yuan.md
      - 陕西铁路工程职业技术学院: universities/shan-xi-tie-lu-gong-cheng-zhi-ye-ji-zhu-xue-yuan.md
    - 甘肃:
      - 兰州交通大学: universities/lan-zhou-jiao-tong-da-xue.md
      - 兰州信息科技学院: universities/lan-zhou-xin-xi-ke-ji-xue-yuan.md
      - 兰州城市学院: universities/lan-zhou-cheng-shi-xue-yuan.md
      - 兰州城市学院培黎校区: universities/lan-zhou-cheng-shi-xue-yuan-pei-li-xiao-qu.md
      - 兰州大学: universities/lan-zhou-da-xue.md
      - 兰州工业学院: universities/lan-zhou-gong-ye-xue-yuan.md
      - 兰州工商学院: universities/lan-zhou-gong-shang-xue-yuan.md
      - 兰州现代职业学院: universities/lan-zhou-xian-dai-zhi-ye-xue-yuan.md
      - 兰州理工大学: universities/lan-zhou-li-gong-da-xue.md
      - 兰州石化职业技术大学: universities/lan-zhou-shi-hua-zhi-ye-ji-zhu-da-xue.md
      - 兰州财经大学: universities/lan-zhou-cai-jing-da-xue.md
      - 兰州资源环境职业技术大学: universities/lan-zhou-zi-yuan-huan-jing-zhi-ye-ji-zhu-da-xue.md
      - 天水师范学院: universities/tian-shui-shi-fan-xue-yuan.md
      - 河西学院: universities/he-xi-xue-yuan.md
      - 甘肃中医药大学: universities/gan-su-zhong-yi-yao-da-xue.md
      - 甘肃农业大学: universities/gan-su-nong-ye-da-xue.md
      - 甘肃政法大学: universities/gan-su-zheng-fa-da-xue.md
      - 甘肃林业职业技术学院: universities/gan-su-lin-ye-zhi-ye-ji-zhu-xue-yuan.md
      - 甘肃民族师范学院: universities/gan-su-min-zu-shi-fan-xue-yuan.md
      - 甘肃警察职业学院: universities/gan-su-jing-cha-zhi-ye-xue-yuan.md
      - 西北师范大学: universities/xi-bei-shi-fan-da-xue.md
      - 西北民族大学: universities/xi-bei-min-zu-da-xue.md
      - 西北民族大学榆中校区: universities/xi-bei-min-zu-da-xue-yu-zhong-xiao-qu.md
      - 陇东学院: universities/long-dong-xue-yuan.md
    - 青海:
      - 青海农牧科技职业学院: universities/qing-hai-nong-mu-ke-ji-zhi-ye-xue-yuan.md
      - 青海大学: universities/qing-hai-da-xue.md
      - 青海师范大学: universities/qing-hai-shi-fan-da-xue.md
      - 青海民族大学: universities/qing-hai-min-zu-da-xue.md
    - 宁夏:
      - 北方民族大学: universities/bei-fang-min-zu-da-xue.md
      - 宁夏医科大学: universities/zhu-xia-yi-ke-da-xue.md
      - 宁夏大学: universities/zhu-xia-da-xue.md
      - 宁夏大学在中卫市就读: universities/zhu-xia-da-xue-zai-zhong-wei-shi-jiu-du.md
      - 宁夏大学新华学院: universities/zhu-xia-da-xue-xin-hua-xue-yuan.md
      - 宁夏建设职业技术学院: universities/zhu-xia-jian-she-zhi-ye-ji-zhu-xue-yuan.md
      - 宁夏理工学院: universities/zhu-xia-li-gong-xue-yuan.md
      - 银川科技学院: universities/yin-chuan-ke-ji-xue-yuan.md
      - 银川能源学院: universities/yin-chuan-neng-yuan-xue-yuan.md
    - 新疆:
      - 中国石油大学北京克拉玛依校区: universities/zhong-guo-shi-you-da-xue-bei-jing-ke-la-ma-yi-xiao-qu.md
      - 乌鲁木齐职业大学: universities/wu-lu-mu-qi-zhi-ye-da-xue.md
      - 伊犁师范大学: universities/yi-li-shi-fan-da-xue.md
      - 克拉玛依职业技术学院: universities/ke-la-ma-yi-zhi-ye-ji-zhu-xue-yuan.md
      - 喀什大学: universities/ke-shi-da-xue.md
      - 塔里木大学: universities/ta-li-mu-da-xue.md
      - 塔里木职业技术学院: universities/ta-li-mu-zhi-ye-ji-zhu-xue-yuan.md
      - 新疆农业大学: universities/xin-jiang-nong-ye-da-xue.md
      - 新疆医科大学: universities/xin-jiang-yi-ke-da-xue.md
      - 新疆大学: universities/xin-jiang-da-xue.md
      - 新疆工程学院: universities/xin-jiang-gong-cheng-xue-yuan.md
      - 新疆师范大学: universities/xin-jiang-shi-fan-da-xue.md
      - 新疆建设职业技术学院: universities/xin-jiang-jian-she-zhi-ye-ji-zhu-xue-yuan.md
      - 新疆政法学院: universities/xin-jiang-zheng-fa-xue-yuan.md
      - 新疆理工学院: universities/xin-jiang-li-gong-xue-yuan.md
      - 新疆科技学院: universities/xin-jiang-ke-ji-xue-yuan.md
      - 新疆第二医学院: universities/xin-jiang-di-er-yi-xue-yuan.md
      - 新疆艺术学院: universities/xin-jiang-yi-zhu-xue-yuan.md
      - 新疆财经大学: universities/xin-jiang-cai-jing-da-xue.md
      - 昌吉学院: universities/chang-ji-xue-yuan.md
      - 石河子大学: universities/shi-he-zi-da-xue.md
    - 其他:
      - 123: universities/123.md
      - Imperial College London: universities/imperial-college-london.md
      - Mcmaster University: universities/mcmaster-university.md
      - Ritsumeikan University Osaka-Ibaraki Campus: universities/ritsumeikan-university-osaka-ibaraki-campus.md
      - Santa Clara University: universities/santa-clara-university.md
      - University of Alberta: universities/university-of-alberta.md
      - University of California, Davis: universities/university-of-california-davis.md
      - University of Manchester: universities/university-of-manchester.md
      - University of Nottingham: universities/university-of-nottingham.md
      - University of Toronto Mississauga: universities/university-of-toronto-mississauga.md
      - University of Wisconsin, Madison: universities/university-of-wisconsin-madison.md
      - h m q 2702056270: universities/h-m-q-2702056270.md
      - miskatonic university: universities/miskatonic-university.md
      - 上海台商子女学校: universities/shang-hai-tai-shang-zi-nu-xue-xiao.md
      - 上海市工商外国语学院: universities/shang-hai-shi-gong-shang-wai-guo-yu-xue-yuan.md
      - 上海济光职业学校: universities/shang-hai-ji-guang-zhi-ye-xue-xiao.md
      - 东京大学: universities/dong-jing-da-xue.md
      - 东北师范: universities/dong-bei-shi-fan.md
      - 中南林业科技涉外学院: universities/zhong-nan-lin-ye-ke-ji-she-wai-xue-yuan.md
      - 九江市理工职业技术学校: universities/jiu-jiang-shi-li-gong-zhi-ye-ji-zhu-xue-xiao.md
      - 保定市科技中等专业学校: universities/bao-ding-shi-ke-ji-zhong-deng-zhuan-ye-xue-xiao.md
      - 信阳师范大学: universities/xin-yang-shi-fan-da-xue.md
      - 信阳师范大学学院: universities/xin-yang-shi-fan-da-xue-xue-yuan.md
      - 共青科技职业学校: universities/gong-qing-ke-ji-zhi-ye-xue-xiao.md
      - 加里敦大学: universities/jia-li-dun-da-xue.md
      - 北京电子信息技师学院: universities/bei-jing-dian-zi-xin-xi-ji-shi-xue-yuan.md
      - 南京航天航空大学金城学院: universities/nan-jing-hang-tian-hang-kong-da-xue-jin-cheng-xue-yuan.md
      - 南宁学校: universities/nan-zhu-xue-xiao.md
      - 南岳衡山道院南岳坤道学院: universities/nan-yue-heng-shan-dao-yuan-nan-yue-kun-dao-xue-yuan.md
      - 卡塞尔学院: universities/qia-sai-er-xue-yuan.md
      - 厦门外国语学校集美校区: universities/sha-men-wai-guo-yu-xue-xiao-ji-mei-xiao-qu.md
      - 发的: universities/fa-de.md
      - 吉安幼儿师范高等专科学校: universities/ji-an-you-er-shi-fan-gao-deng-zhuan-ke-xue-xiao.md
      - 吕梁师范高等专科学校: universities/lu-liang-shi-fan-gao-deng-zhuan-ke-xue-xiao.md
      - 和君职业学院: universities/he-jun-zhi-ye-xue-yuan.md
      - 唐山工业职业职业技术学院: universities/tang-shan-gong-ye-zhi-ye-zhi-ye-ji-zhu-xue-yuan.md
      - 嘉兴大学: universities/jia-xing-da-xue.md
      - 四川工程职业技术大学: universities/si-chuan-gong-cheng-zhi-ye-ji-zhu-da-xue.md
      - 四川托普信息职业技术学院: universities/si-chuan-tuo-pu-xin-xi-zhi-ye-ji-zhu-xue-yuan.md
      - 天津交通职业技术学院: universities/tian-jin-jiao-tong-zhi-ye-ji-zhu-xue-yuan.md
      - 天津市建筑工程学校: universities/tian-jin-shi-jian-zhu-gong-cheng-xue-xiao.md
      - 天津市生物工程职业技术学院: universities/tian-jin-shi-sheng-wu-gong-cheng-zhi-ye-ji-zhu-xue-yuan.md
      - 天津市电子信息技师学院 天津市仪表无线电工业学校: universities/tian-jin-shi-dian-zi-xin-xi-ji-shi-xue-yuan-tian-jin-shi-yi-biao-wu-xian-dian-gong-ye-xue-xiao.md
      - 宁夏师范大学: universities/zhu-xia-shi-fan-da-xue.md
      - 宁都私立英才: universities/zhu-du-si-li-ying-cai.md
      - 安徽省医科大学: universities/an-hui-sheng-yi-ke-da-xue.md
      - 安徽警官职业技术学院: universities/an-hui-jing-guan-zhi-ye-ji-zhu-xue-yuan.md
      - 安徽高等专科学校: universities/an-hui-gao-deng-zhuan-ke-xue-xiao.md
      - 宝鸡职业技术学校: universities/bao-ji-zhi-ye-ji-zhu-xue-xiao.md
      - 寸金: universities/cun-jin.md
      - 山东交通职业技术学院: universities/shan-dong-jiao-tong-zhi-ye-ji-zhu-xue-yuan.md
      - 山东省临沂卫生学校: universities/shan-dong-sheng-lin-yi-wei-sheng-xue-xiao.md
      - 山东第二医科大学: universities/shan-dong-di-er-yi-ke-da-xue.md
      - 山东铝业职业技术学院威海校区: universities/shan-dong-lu-ye-zhi-ye-ji-zhu-xue-yuan-wei-hai-xiao-qu.md
      - 山河大学: universities/shan-he-da-xue.md
      - 山西国际商务学院: universities/shan-xi-guo-ji-shang-wu-xue-yuan.md
      - 山西财政税务专科学校: universities/shan-xi-cai-zheng-shui-wu-zhuan-ke-xue-xiao.md
      - 岳阳现代服务职业学院: universities/yue-yang-xian-dai-fu-wu-zhi-ye-xue-yuan.md
      - 常州中国铁道高等职业技术学校: universities/chang-zhou-zhong-guo-tie-dao-gao-deng-zhi-ye-ji-zhu-xue-xiao.md
      - 平顶山市一中新区: universities/ping-ding-shan-shi-yi-zhong-xin-qu.md
      - 广东省南华工商职业学院: universities/yan-dong-sheng-nan-hua-gong-shang-zhi-ye-xue-yuan.md
      - 广东省电子商务技师学院: universities/yan-dong-sheng-dian-zi-shang-wu-ji-shi-xue-yuan.md
      - 广东轻工职业技术大学南海北校区: universities/yan-dong-qing-gong-zhi-ye-ji-zhu-da-xue-nan-hai-bei-xiao-qu.md
      - 广丰金桥: universities/yan-feng-jin-qiao.md
      - 广州华立科技职业技术学院: universities/yan-zhou-hua-li-ke-ji-zhi-ye-ji-zhu-xue-yuan.md
      - 广州市财经商贸职业技术学校: universities/yan-zhou-shi-cai-jing-shang-mao-zhi-ye-ji-zhu-xue-xiao.md
      - 广西融水民族卫生学校: universities/yan-xi-rong-shui-min-zu-wei-sheng-xue-xiao.md
      - 应急管理大学: universities/ying-ji-guan-li-da-xue.md
      - 张家界航空职业技术学院: universities/zhang-jia-jie-hang-kong-zhi-ye-ji-zhu-xue-yuan.md
      - 慕尼黑大学: universities/mu-ni-hei-da-xue.md
      - 成都机电工程学校: universities/cheng-du-ji-dian-gong-cheng-xue-xiao.md
      - 新华: universities/xin-hua.md
      - 新疆轻工职业技术学校: universities/xin-jiang-qing-gong-zhi-ye-ji-zhu-xue-xiao.md
      - 早稻田大学: universities/zao-dao-tian-da-xue.md
      - 昆明传媒学院: universities/kun-ming-chuan-mei-xue-yuan.md
      - 柳州职业技术大学下周更名: universities/liu-zhou-zhi-ye-ji-zhu-da-xue-xia-zhou-geng-ming.md
      - 栾川县中等职业学校: universities/luan-chuan-xian-zhong-deng-zhi-ye-xue-xiao.md
      - 武汉光谷职业技术学院: universities/wu-yi-guang-gu-zhi-ye-ji-zhu-xue-yuan.md
      - 永康五金技师学院: universities/yong-kang-wu-jin-ji-shi-xue-yuan.md
      - 永康市职业技术学校: universities/yong-kang-shi-zhi-ye-ji-zhu-xue-xiao.md
      - 江苏农牧科技职业技术学院: universities/jiang-su-nong-mu-ke-ji-zhi-ye-ji-zhu-xue-yuan.md
      - 江苏安全技术职业技术学院云龙校区: universities/jiang-su-an-quan-ji-zhu-zhi-ye-ji-zhu-xue-yuan-yun-long-xiao-qu.md
      - 江苏省交通技师学院: universities/jiang-su-sheng-jiao-tong-ji-shi-xue-yuan.md
      - 江苏省常州技师学院: universities/jiang-su-sheng-chang-zhou-ji-shi-xue-yuan.md
      - 江苏联合职业学院泰州机电分院: universities/jiang-su-lian-he-zhi-ye-xue-yuan-tai-zhou-ji-dian-fen-yuan.md
      - 江西工程高级技工学校: universities/jiang-xi-gong-cheng-gao-ji-ji-gong-xue-xiao.md
      - 江西应用科技: universities/jiang-xi-ying-yong-ke-ji.md
      - 江西省应用技术学院: universities/jiang-xi-sheng-ying-yong-ji-zhu-xue-yuan.md
      - 江西省建筑工业学校: universities/jiang-xi-sheng-jian-zhu-gong-ye-xue-xiao.md
      - 江西经济管理干部学院: universities/jiang-xi-jing-ji-guan-li-gan-bu-xue-yuan.md
      - 河北中医药大学: universities/he-bei-zhong-yi-yao-da-xue.md
      - 河北省青年管理干部学院: universities/he-bei-sheng-qing-nian-guan-li-gan-bu-xue-yuan.md
      - 河北经济管理学院: universities/he-bei-jing-ji-guan-li-xue-yuan.md
      - 河北资源环境职业技术学院: universities/he-bei-zi-yuan-huan-jing-zhi-ye-ji-zhu-xue-yuan.md
      - 河南经贸: universities/he-nan-jing-mao.md
      - 泸州天立学校: universities/lu-zhou-tian-li-xue-xiao.md
      - 浙江省机电技师学院: universities/zhe-jiang-sheng-ji-dian-ji-shi-xue-yuan.md
      - 浙江省水利水电学院: universities/zhe-jiang-sheng-shui-li-shui-dian-xue-yuan.md
      - 浙江科技大学: universities/zhe-jiang-ke-ji-da-xue.md
      - 浙江科技大学安吉校区: universities/zhe-jiang-ke-ji-da-xue-an-ji-xiao-qu.md
      - 浙江药科职业大学: universities/zhe-jiang-yao-ke-zhi-ye-da-xue.md
      - 海亮外国语学校: universities/hai-liang-wai-guo-yu-xue-xiao.md
      - 海南比勒费尔德应用科学大学: universities/hai-nan-bi-le-fei-er-de-ying-yong-ke-xue-da-xue.md
      - 淄博职业学校: universities/zi-bo-zhi-ye-xue-xiao.md
      - 深圳技师学院: universities/shen-zhen-ji-shi-xue-yuan.md
      - 深圳技师学院/深圳城市职业学院: universities/shen-zhen-ji-shi-xue-yuan-shen-zhen-cheng-shi-zhi-ye-xue-yuan.md
      - 深圳鹏城技师学院: universities/shen-zhen-peng-cheng-ji-shi-xue-yuan.md
      - 清华: universities/qing-hua.md
      - 漳州技师学院: universities/zhang-zhou-ji-shi-xue-yuan.md
      - 澳大利亚国立大学: universities/ao-da-li-ya-guo-li-da-xue.md
      - 澳门大学: universities/ao-men-da-xue.md
      - 澳门理工大学: universities/ao-men-li-gong-da-xue.md
      - 澳门科技大学: universities/ao-men-ke-ji-da-xue.md
      - 烟台城市科技职业学院: universities/yan-tai-cheng-shi-ke-ji-zhi-ye-xue-yuan.md
      - 牡丹江医科大学: universities/mu-dan-jiang-yi-ke-da-xue.md
      - 珠海市卫生学校: universities/zhu-hai-shi-wei-sheng-xue-xiao.md
      - 珠海市技师学院: universities/zhu-hai-shi-ji-shi-xue-yuan.md
      - 甘肃省农业职业技术学院: universities/gan-su-sheng-nong-ye-zhi-ye-ji-zhu-xue-yuan.md
      - 石家庄工商职业技术学院: universities/shi-jia-zhuang-gong-shang-zhi-ye-ji-zhu-xue-yuan.md
      - 福州师范大学: universities/fu-zhou-shi-fan-da-xue.md
      - 福建三明林业学校: universities/fu-jian-san-ming-lin-ye-xue-xiao.md
      - 福建旅游职业中专学校: universities/fu-jian-lu-you-zhi-ye-zhong-zhuan-xue-xiao.md
      - 福建理工大学: universities/fu-jian-li-gong-da-xue.md
      - 福建航政交通职业学院: universities/fu-jian-hang-zheng-jiao-tong-zhi-ye-xue-yuan.md
      - 福清西山学校高中部: universities/fu-qing-xi-shan-xue-xiao-gao-zhong-bu.md
      - 耒阳师范: universities/lei-yang-shi-fan.md
      - 苏州信息职业技术学校: universities/su-zhou-xin-xi-zhi-ye-ji-zhu-xue-xiao.md
      - 苏州市职业大学: universities/su-zhou-shi-zhi-ye-da-xue.md
      - 苏州托普信息技术学院: universities/su-zhou-tuo-pu-xin-xi-ji-zhu-xue-yuan.md
      - 菏泽艺术学校: universities/he-ze-yi-zhu-xue-xiao.md
      - 萧山二职: universities/xiao-shan-er-zhi.md
      - 蚌埠医科大学: universities/bang-bu-yi-ke-da-xue.md
      - 蜀山男子职业技术学院: universities/shu-shan-nan-zi-zhi-ye-ji-zhu-xue-yuan.md
      - 衡阳技师学院: universities/heng-yang-ji-shi-xue-yuan.md
      - 西南联大: universities/xi-nan-lian-da.md
      - 西安航空职业技术学校: universities/xi-an-hang-kong-zhi-ye-ji-zhu-xue-xiao.md
      - 贵州中医药时珍学院: universities/gui-zhou-zhong-yi-yao-shi-zhen-xue-yuan.md
      - 贵阳市女子职业学校马王庙校区: universities/gui-yang-shi-nu-zi-zhi-ye-xue-xiao-ma-wang-miao-xiao-qu.md
      - 赣南医科大学黄金校区: universities/gan-nan-yi-ke-da-xue-huang-jin-xiao-qu.md
      - 邢台医学高等专科: universities/xing-tai-yi-xue-gao-deng-zhuan-ke.md
      - 郑州警察学院: universities/zheng-zhou-jing-cha-xue-yuan.md
      - 郑州软件职业技术学院: universities/zheng-zhou-ruan-jian-zhi-ye-ji-zhu-xue-yuan.md
      - 郑州食品工程职业学院: universities/zheng-zhou-shi-pin-gong-cheng-zhi-ye-xue-yuan.md
      - 郓城县高级技工学校: universities/yun-cheng-xian-gao-ji-ji-gong-xue-xiao.md
      - 鄂州大学: universities/e-zhou-da-xue.md
      - 重庆中医药学院: universities/zhong-qing-zhong-yi-yao-xue-yuan.md
      - 重庆五一职业技术学院: universities/zhong-qing-wu-yi-zhi-ye-ji-zhu-xue-yuan.md
      - 重庆市黔江区职业教育中心: universities/zhong-qing-shi-qian-jiang-qu-zhi-ye-jiao-yu-zhong-xin.md
      - 重庆电子职业工程学院: universities/zhong-qing-dian-zi-zhi-ye-gong-cheng-xue-yuan.md
      - 重庆科技大学: universities/zhong-qing-ke-ji-da-xue.md
      - 重庆能源职业技术学院: universities/zhong-qing-neng-yuan-zhi-ye-ji-zhu-xue-yuan.md
      - 重庆财经职业技术学院: universities/zhong-qing-cai-jing-zhi-ye-ji-zhu-xue-yuan.md
      - 金华曙光学校: universities/jin-hua-shu-guang-xue-xiao.md
      - 金声奖: universities/jin-sheng-jiang.md
      - 长春市博大中等职业学校: universities/chang-chun-shi-bo-da-zhong-deng-zhi-ye-xue-xiao.md
      - 阜新市第二职专: universities/fu-xin-shi-di-er-zhi-zhuan.md
      - 阜阳理工学院: universities/fu-yang-li-gong-xue-yuan.md
      - 阜阳理工学院西湖新城校区: universities/fu-yang-li-gong-xue-yuan-xi-hu-xin-cheng-xiao-qu.md
      - 阳江市职业技术学院: universities/yang-jiang-shi-zhi-ye-ji-zhu-xue-yuan.md
      - 陇南师范高等学校: universities/long-nan-shi-fan-gao-deng-xue-xiao.md
      - 陕西建筑科技大学: universities/shan-xi-jian-zhu-ke-ji-da-xue.md
      - 雅安天立学校: universities/ya-an-tian-li-xue-xiao.md
      - 香港城市大学: universities/xiang-gang-cheng-shi-da-xue.md
      - 香港大学: universities/xiang-gang-da-xue.md
      - 香港恒生大学/The Hang Seng University of Hong Kong: universities/xiang-gang-heng-sheng-da-xue-the-hang-seng-university-of-hong-kong.md
      - 香港珠海学院: universities/xiang-gang-zhu-hai-xue-yuan.md
      - 香港理工大学: universities/xiang-gang-li-gong-da-xue.md
      - 香港科技大学: universities/xiang-gang-ke-ji-da-xue.md
      - 香港科技大学广州: universities/xiang-gang-ke-ji-da-xue-yan-zhou.md
      - 马鞍山高等师范专科学校: universities/ma-an-shan-gao-deng-shi-fan-zhuan-ke-xue-xiao.md
      - 鹤壁工程技术学院: universities/he-bi-gong-cheng-ji-zhu-xue-yuan.md
      - 黑龙江能源职业技术学院: universities/hei-long-jiang-neng-yuan-zhi-ye-ji-zhu-xue-yuan.md
      - 齐河职专: universities/qi-he-zhi-zhuan.md
      - 齐齐哈尔高等示范专科院校: universities/qi-qi-ha-er-gao-deng-shi-fan-zhuan-ke-yuan-xiao.md
